âŒš	orologio	orologio|orologio da polso|tempo
âŒ›	clessidra	clessidra|sabbia|tempo
â©	pulsante di avanzamento rapido	avanzamento rapido|destra|doppia freccia a destra|fast forward|freccia|pulsante di avanzamento rapido|triangolo
âª	pulsante di riavvolgimento rapido	doppia freccia a sinistra|freccia|pulsante di riavvolgimento rapido|rewind|riavvolgimento rapido|sinistra
â«	pulsante doppia freccia in alto	alto|doppia freccia in alto|freccia|pulsante doppia freccia in alto
â¬	doppia freccia in basso	basso|doppia freccia in basso|freccia
â°	sveglia	attesa|mattino|ora|ore|suono|sveglia|svegliarsi|tempo
â³	clessidra che scorre	clessidra|clessidra che scorre|sabbia|tempo
â—½	quadrato bianco medio-piccolo	geometria|quadrato|quadrato bianco medio-piccolo
â—¾	quadrato nero medio-piccolo	geometria|quadrato|quadrato nero medio-piccolo
â˜”	ombrello con gocce di pioggia	diluvio|gocce dâ€™acqua|meteo|natura|ombrello|ombrello bagnato|ombrello con gocce di pioggia|pioggia
â˜•	bevanda calda	bevanda|bevanda calda|caffÃ¨|fumante|tÃ¨ caldo|the|thÃ¨
â™ˆ	Segno zodiacale dellâ€™Ariete	Ariete|Segno zodiacale dellâ€™Ariete|zodiaco
â™‰	Segno zodiacale del Toro	oroscopo|segno zodiacale|Segno zodiacale del Toro|Toro|zodiaco
â™Š	Segno zodiacale dei Gemelli	Gemelli|oroscopo|segno zodiacale|Segno zodiacale dei Gemelli|zodiaco
â™‹	Segno zodiacale del Cancro	Cancro|oroscopo|segno zodiacale|Segno zodiacale del Cancro|zodiaco
â™Œ	Segno zodiacale del Leone	Leone|oroscopo|segno zodiacale|Segno zodiacale del Leone|zodiaco
â™	Segno zodiacale della Vergine	oroscopo|segno zodiacale|Segno zodiacale della Vergine|Vergine|zodiaco
â™	Segno zodiacale della Bilancia	Bilancia|oroscopo|segno zodiacale|Segno zodiacale della Bilancia|zodiaco
â™	Segno zodiacale dello Scorpione	oroscopo|Scorpione|segno zodiacale|Segno zodiacale dello Scorpione|zodiaco
â™	Segno zodiacale del Saggitario	oroscopo|Sagittario|segno zodiacale|Segno zodiacale del Saggitario|zodiaco
â™‘	Segno zodiacale del Capricorno	Capricorno|oroscopo|segno zodiacale|Segno zodiacale del Capricorno|zodiaco
â™’	Segno zodiacale dellâ€™Acquario	Acquario|segno zodiacale|Segno zodiacale dellâ€™Acquario|zodiaco
â™“	Segno zodiacale dei Pesci	oroscopo|Pesci|segno zodiacale|Segno zodiacale dei Pesci|zodiaco
â™¿	simbolo della disabilitÃ 	accesso|accesso sedia a rotelle|disabile|sedia a rotelle|simbolo|simbolo della disabilitÃ |simbolo sedia a rotelle
âš“	ancora	ancora|mare|marina|marinaio|nave|simbolo
âš¡	alta tensione	alta|fulmine|pericolo|simbolo|tensione|tuono
âšª	cerchio bianco	bianco|cerchio|cerchio bianco grande|geometria
âš«	cerchio nero	cerchio|cerchio nero grande|geometria|nero
âš½	pallone da calcio	calcetto|calcio|palla|pallone|pallone da calcio|sport
âš¾	palla da baseball	baseball|battitore|guantone|mazza|palla da baseball|ricevitore|sport
â›„	pupazzo di neve senza neve	inverno|natura|neve|pupazzo|pupazzo di neve|pupazzo di neve senza neve
â›…	sole coperto	meteo|natura|nuvola|sole|sole con nuvole|sole coperto|variabile
â›	Segno zodiacale dellâ€™Ofiuco	Ofiuco|segno zodiacale|Segno zodiacale dellâ€™Ofiuco|zodiaco
â›”	segnale di divieto di accesso	accesso|divieto|divieto di accesso|proibito|segnale di divieto di accesso|simbolo|stop|vietato
â›ª	chiesa	cappella|cattedrale|chiesa|cristianesimo|croce|edificio|religione
â›²	fontana	acqua|acqua che scorre|fontana
â›³	bandiera in buca	bandiera golf|bandiera in buca|bandierina|buca|golf
â›µ	barca a vela	barca|barca a vela|localitÃ  balneare|mare|sport|vacanza|vela|yacht
â›º	tenda	accampamento|campeggio|tenda
â›½	stazione di servizio	benzina|carburante|fare il pieno|pieno|pompa di benzina|stazione|stazione di servizio
âœ…	pulsante segno di spunta	baffo|fatto|pulsante segno di spunta|segno di spunta|segno di spunta grande|spunta
âœŠ	pugno	alzato|lotta|mano|pugno|pugno chiuso|sasso|solidarietÃ 
âœ‹	mano alzata	alzata|carta|cinque|mano|mano aperta
âœ¨	stelline	scintille|spendente|stelle|stelline
âŒ	croce	croce|croce rossa|moltiplicazione|X
â	croce con quadrato	croce con quadrato|croce verde|moltiplicazione|X con quadrato
â“	punto interrogativo rosso	?|domanda|punteggiatura|punto di domanda|punto di domanda pieno|punto interrogativo|punto interrogativo rosso
â”	punto interrogativo bianco	?|domanda|punteggiatura|punto di domanda|punto di domanda vuoto|punto interrogativo|punto interrogativo bianco|punto interrogativo grigio
â•	punto esclamativo bianco	!|esclamazione|punteggiatura|punto esclamativo|punto esclamativo bianco|punto esclamativo grigio|punto esclamativo vuoto
â—	punto esclamativo rosso	esclamazione|punteggiatura|punto esclamativo|punto esclamativo pieno|punto esclamativo rosso
â•	addizione	+|addizione|croce|matematica|piÃ¹|segno|segno di addizione
â–	sottrazione	-|matematica|meno|segno|segno di sottrazione|sottrazione|trattino
â—	divisione	Ã·|divisione|diviso|matematica|segno|segno di divisione
â°	occhiello	cerchio|nodo|occhiello
â¿	doppio occhiello	doppio|occhiello
â¬›	quadrato nero grande	geometria|quadrato|quadrato nero grande
â¬œ	quadrato bianco grande	geometria|quadrato|quadrato bianco grande
â­	stella	astro|natura|stella|stella gialla|stellina
â­•	cerchio rosso vuoto	cerchio|cerchio rosso vuoto|gioco|pallino|tris
ğŸ€„	tessera Mahjong	drago|drago rosso|Mahjong|tessera
ğŸƒ	jolly	carta|carta da gioco|gioco|Joker|jolly
ğŸ†	gruppo sanguigno AB	AB|gruppo AB|gruppo sanguigno AB
ğŸ†‘	pulsante CL	bottone|CL|pulsante|simbolo
ğŸ†’	pulsante COOL	cool|pulsante|simbolo|tasto
ğŸ†“	pulsante FREE	free|gratis|libero|pulsante|simbolo|tasto
ğŸ†”	pulsante ID	ID|identitÃ |pulsante ID|simbolo ID
ğŸ†•	pulsante NEW	new|nuovo|pulsante|simbolo|tasto
ğŸ†–	pulsante NG	NG|pulsante|simbolo NG|tasto
ğŸ†—	pulsante OK	OK|pulsante|simbolo|tasto
ğŸ†˜	pulsante SOS	aiuto|pulsante SOS|Segnale di SOS|simbolo di SOS|simbolo SOS|soccorsi|soccorso|SOS
ğŸ†™	pulsante UP!	alto|in alto|pulsante|simbolo UP!|sÃ¹|tasto UP!|UP!
ğŸ†š	pulsante VS	contro|pulsante|simbolo contro|tasto|versus|vs
ğŸˆ	ideogramma giapponese per â€œQuiâ€	giapponese|katakana|parola|pulsante|qui|simbolo|tabelloni|tasto|ã‚³ã‚³
ğŸˆš	ideogramma giapponese di â€œGratisâ€	giapponese|gratis|ideogramma|ideogramma giapponese di â€œGratisâ€|negazione
ğŸˆ¯	ideogramma giapponese di â€œRiservatoâ€	direzione|dito|giapponese|ideogramma|ideogramma giapponese di â€œRiservatoâ€|indicare|riservato
ğŸˆ²	ideogramma giapponese di â€œProibitoâ€	giapponese|ideogramma|ideogramma giapponese di â€œProibitoâ€|proibito
ğŸˆ³	ideogramma giapponese di â€œPosto liberoâ€	cinese|disponibilitÃ |giapponese|ideogramma|ideogramma giapponese di â€œPosto liberoâ€|libero|posto libero|vuoto
ğŸˆ´	ideogramma giapponese di â€œVoto di sufficienzaâ€	cinese|giapponese|ideogramma|ideogramma giapponese di â€œVoto di sufficienzaâ€|insieme|sufficienza
ğŸˆµ	ideogramma giapponese di â€œNessun posto liberoâ€	cinese|giapponese|ideogramma|ideogramma giapponese di â€œNessun posto liberoâ€|nessun posto libero|pienezza|pieno
ğŸˆ¶	ideogramma giapponese di â€œA pagamentoâ€	esistere|giapponese|ideogramma|ideogramma giapponese di â€œA pagamentoâ€
ğŸˆ¸	ideogramma giapponese di â€œCandidaturaâ€	applicare|candidarsi|cinese|giapponese|ideogramma|ideogramma giapponese di â€œCandidaturaâ€
ğŸˆ¹	ideogramma giapponese di â€œScontoâ€	dividere|giapponese|ideogramma|ideogramma giapponese di â€œScontoâ€|prezzo scontato|sconto
ğŸˆº	ideogramma giapponese di â€œAperto al pubblicoâ€	aperto|aperto al pubblico|aperto per affari|cinese|giapponese|ideogramma|ideogramma giapponese di â€œAperto al pubblicoâ€|ideogramma in funzione|in funzione
ğŸ‰	ideogramma giapponese di â€œOccasioneâ€	giapponese|ideogramma|ideogramma giapponese di â€œOccasioneâ€|vantaggio
ğŸ‰‘	ideogramma giapponese di â€œAccettabileâ€	accettabile|accettare|cinese|giapponese|ideogramma|ideogramma giapponese di â€œAccettabileâ€
ğŸŒ€	ciclone	ciclone|mal di mare|meteo|nausea|spirale|tifone|tornado|vento
ğŸŒ	nebbioso	clima|meteo|montagna con la nebbia|nebbia|nebbioso
ğŸŒ‚	ombrello chiuso	meteo|ombrello chiuso|pioggia|piovere
ğŸŒƒ	notte stellata	cielo|cittÃ |cittÃ  di notte|luna|notte|notte stellata|stelle
ğŸŒ„	alba sulle montagne	alba|alba sulle montagne|montagna|montagne|paesaggio|sole|sole che sorge|tramonto
ğŸŒ…	alba	alba|finestra|mattino|natura|sole|sole che sorge
ğŸŒ†	cittÃ  al tramonto	cittÃ |cittÃ  al tramonto|edifici|paesaggio|tramonto
ğŸŒ‡	tramonto	cittÃ |skyline|sole che tramonta sulla cittÃ |tramonto
ğŸŒˆ	arcobaleno	arcobaleno|bisessuale|colori|gay|lesbica|lgbt|meteo|natura|omosessuale|pace|pioggia|transgender
ğŸŒ‰	ponte di notte	Golden Gate|notte|paesaggio|ponte|ponte di notte|San Francisco
ğŸŒŠ	onda	acqua|la grande onda|mare|natura|oceano|onda|onda dâ€™acqua|onda del mare|surf
ğŸŒ‹	vulcano	eruzione|etna|Etna|lava|natura|Vesuvio|vulcano|vulcano in eruzione
ğŸŒŒ	Via Lattea	lattea|nebulosa|notte|spazio|stelle|Via Lattea
ğŸŒ	Europa e Africa	Africa|Europa|Europa e Africa|globo|mappamondo|natura|pianeta|terra
ğŸŒ	America	America|Americhe|globo|mappamondo|natura|pianeta|terra
ğŸŒ	Asia e Australia	Asia|Asia e Australia|Australia|globo|mappamondo|natura|pianeta|terra|Terra
ğŸŒ	globo con meridiani	globo|globo con meridiani|meridiani
ğŸŒ‘	luna nuova	cielo|luna|luna nera|natura|notte|novilunio|nuova
ğŸŒ’	luna crescente	buona notte|crescente|luna|mezza luna|natura|notte|quarto di luna|sogni|spicchio di luna
ğŸŒ“	primo quarto di luna	luna|natura|notte|primo quarto di luna|quarto
ğŸŒ”	luna gibbosa crescente	crescente|gibbosa|luna|natura|notte
ğŸŒ•	luna piena	luna|natura|notte|piena|plenilunio
ğŸŒ–	luna gibbosa calante	calante|gibbosa|luna|luna quasi pieni|natura|notte
ğŸŒ—	ultimo quarto di luna	luna|metÃ |natura|notte|quarto|spazio|ultimo quarto di luna
ğŸŒ˜	luna calante	calante|luna|natura|notte
ğŸŒ™	spicchio di luna	calante|cielo|crescente|gobba|luna|natura|notte|spazio|spicchio di luna|ultimo quarto
ğŸŒš	faccina luna nuova	faccina|faccina luna nuova|luna|luna nera|luna nuova|luna nuova con faccina|natura|notte
ğŸŒ›	faccina primo quarto di luna	cielo|faccina|faccina primo quarto di luna|luna|luna con faccina|natura|notte|primo quarto di luna|quarto di luna con faccina
ğŸŒœ	faccina ultimo quarto di luna	faccina|faccina della luna|faccina ultimo quarto di luna|luna|luna con faccina|natura|notte|quarto di luna con faccina|ultimo quarto di luna
ğŸŒ	faccina luna piena	faccina|faccina con la luna|faccina della luna|faccina luna piena|luna|luna con faccina|luna piena|luna piena con faccina|natura
ğŸŒ	faccina sole	bel tempo|caldo|denari|estate|faccina|giornata|giorno|meteo|sole|soleggiato
ğŸŒŸ	stella che brilla	brillante|evvai|felicitÃ |festeggiare|natura|notte|scintillante|sorpresa|stella|stella che brilla|stella con scintille|stellina
ğŸŒ 	stella cadente	cadente|desiderio|fortuna|notte|stella
ğŸŒ­	hot dog	cibo|hot dog|panino|street food|wurstel
ğŸŒ®	taco	cibo|cucina messicana|guacamole|messicana|messicano|Messico|ristorante|salsa|taco|tacos
ğŸŒ¯	burrito	burrito|cucina messicana|Messico
ğŸŒ°	castagna	autunno|bosco|caldarroste|castagna|cibo|frutta|frutto|nocciola
ğŸŒ±	germoglio	germoglio|natura|pianta|piantina|primavera
ğŸŒ²	albero sempreverde	abete|albero|albero di natale|conifera|foresta|natura|pino|sempreverde
ğŸŒ³	albero deciduo	albero|albero rotondo|caduco|deciduo|natura|pianta
ğŸŒ´	palma	albero|natura|palma|spiaggia|tropicale|tropici
ğŸŒµ	cactus	cactus|caldo|deserto|messico|natura|pianta|pianta grassa|spina|spine|west
ğŸŒ·	tulipano	fiore|giardino|natura|pianta|rosa|tulipano
ğŸŒ¸	fiore di ciliegio	ciliegio|fiore|fiore di ciliegio|fiorito|natura|pianta|primavera|primula|rosa
ğŸŒ¹	rosa	amore|bellezza|fiore|giardino|natura|pianta|regalo|rosa|rosa rossa|rosso
ğŸŒº	ibisco	fiore|ibisco|natura|pianta|rosso
ğŸŒ»	girasole	fiore|giallo|girasole|natura|pianta
ğŸŒ¼	fiore	bocciolo|fiore|fiorellino|giallo|margherita|natura|pianta
ğŸŒ½	pannocchia	cibo|fattoria|granoturco|mais|pannocchia|verdura
ğŸŒ¾	pianta di riso	cereale|natura|pianta|pianta di riso|riso|spiga|spiga di riso
ğŸŒ¿	pianta	foglia|natura|pianta|ramo|verde
ğŸ€	quadrifoglio	foglia|fortuna|natura|pianta|piante|quadrifoglio|quattro
ğŸ	foglia dâ€™acero	autunno|foglia|foglia caduta|foglia dâ€™acero|natura
ğŸ‚	foglia caduta	autunno|cadute foglia|foglia|foglia caduta|foglie|foglie cadute|foglie che cadono|foglie rosse|natura|ramo
ğŸƒ	foglia al vento	foglia|foglia al vento|foglie|vento|vento che soffia
ğŸ„	fungo	amanita|autunno|biancaneve|bosco|favola|fiaba|funghetto|fungo|natura|velenoso
ğŸ„â€ğŸŸ«	fungo marrone	autunno|bosco|champignon|cibo|fungo|fungo marrone|natura|porcino|vegano|vegetale|vegetariano
ğŸ…	pomodoro	cibo|pomodoro|rosso|verdura
ğŸ†	melanzana	cibo|melanzana|verdura
ğŸ‡	uva	cibo|dioniso|frutta|frutto|grappolo|grappolo dâ€™uva|uva|vino|viola
ğŸˆ	melone	cantaloupe|cibo|frutta|frutto|melone|oliva
ğŸ‰	anguria	anguria|cibo|frutta|frutto
ğŸŠ	mandarino	agrume|agrumi|arancia|cibo|frutta|frutto|mandarino|vitamina C
ğŸ‹	limone	agrume|aspro|cibo|estate|frutta|frutto|giallo|limone
ğŸ‹â€ğŸŸ©	lime	agrume|cibo|cocktail|dissetante|frutta|lime|limone|limone verde|mojito|succo|tequila|tropicale
ğŸŒ	banana	banana|cibo|frutta|frutto|potassio
ğŸ	ananas	ananas|cibo|frutta|frutto|pina colada|tropicale
ğŸ	mela rossa	cibo|dieta|frutta|frutto|mela|rossa
ğŸ	mela verde	cibo|dieta|frutta|frutto|mela|verde
ğŸ	pera	cibo|frutta|frutto|pera
ğŸ‘	pesca	cibo|frutta|frutto|pesca
ğŸ’	ciliegie	cibo|ciliegia|ciliegie|frutta|frutto
ğŸ“	fragola	cibo|fragola|frutta|frutto|rosso
ğŸ”	hamburger	burger|cibo|fast food|hamburger|panino|ristorante|sandwich
ğŸ•	pizza	cena|cibo|fame|fetta|fetta di pizza|pizza|pizzeria|ristorante
ğŸ–	carne	barbecue|carne|carne con osso|cibo|fame|osso|ristorante
ğŸ—	coscia di pollo	carne|cibo|coscia|coscia di pollo|coscia di tacchino|fame|osso|pollo|ristorante|tacchino
ğŸ˜	galletta di riso	cibo|galletta di riso|riso
ğŸ™	onigiri	arancino di riso|arancino di riso giapponese|cibo|giapponese|onigiri|orientale|polpetta di riso giapponese|riso|ristorante
ğŸš	riso bollito	cibo|cinese|riso|riso bollito|ristorante
ğŸ›	riso al curry	cibo|curry|India|indiano|riso|riso al curry|ristorante
ğŸœ	ciotola fumante	bacchette|cibo|cinese|ciotola di noodle|ciotola fumante|giapponese|noodle|pho|piatto caldo|ramen|ristorante
ğŸ	spaghetti	cena|cibo|cucina|cucinare|fame|pasta|pranzo|puttanesca|ragÃ¹|ristorante|spaghetti
ğŸ	pane in cassetta	carboidrati|cereali|cibo|pancarrÃ©|pane|pane a cassetta|pane in cassetta|ristorante|toast
ğŸŸ	patatine	cibo|patatine|patatine fritte|ristorante
ğŸ 	patata dolce arrosto	arrosto|cibo|dolce|ortaggio|patata|verdura
ğŸ¡	dango	dango|dolce|dolcetto|palline di mochi|ristorante|spiedino di mochi
ğŸ¢	oden giapponese	cibo|cucina|kebab|oden|oden giapponese|pesce|ristorante|spiedino|spiedino di pesce
ğŸ£	sushi	cibo|cucina|giapponese|riso|ristorante|salmone|sushi
ğŸ¤	gambero fritto	cibo|gamberetto|gambero|gambero fritto|ristorante|tempura
ğŸ¥	tortino di pesce a spirale	cibo|crocchetta di pesce|cucina giapponese|giapponese|pesce|ristorante|rotolo di pesce|spirale|tortino di pesce a spirale
ğŸ¦	cono gelato	bar|cono|crema|dessert|dolce|estate|gelateria|gelato|ristorante|zucchero
ğŸ§	granita	cibo|estate|ghiaccio|granita|granita siciliana|Sicilia
ğŸ¨	coppa di gelato	cibo|coppa di gelato|crema|dessert|dolce|estate|gelateria|gelato|ristorante|zucchero
ğŸ©	ciambella	ciambella|cibo|cioccolato|dolce|donut|ristorante|zucchero
ğŸª	biscotto	biscottino|biscotto|cibo|cioccolato|cookie|dessert|dolce|gocce di cioccolato|ristorante|zucchero
ğŸ«	cioccolato	barretta di cioccolato|break|cibo|cioccolata|cioccolato|dolce|dolcetto|felicitÃ |goloso|halloween|ristorante|snack
ğŸ¬	caramella	caramella|caramelle|dolce|dolcetti|dolcetto|dolci|dolciume|halloween|zucchero
ğŸ­	lecca lecca	caramella|chupa chups|dolce|dolcetti|dolcetto|dolci|lecca lecca|ristorante|willi wonka|zucchero
ğŸ®	budino	budino|cibo|creme caramel|dessert|dolce|dolci|pudding|ristorante|zucchero
ğŸ¯	barattolo di miele	api|barattolo|barattolo di miele|cibo|dolce|miele|ristorante|vaso|vaso di miele|winnie the pooh|zucchero
ğŸ°	fetta di torta	dessert|dolce|fetta|fetta di torta|ristorante|torta|zucchero
ğŸ±	bento box	bento box|lunch box|monoporzione|piatto pronto|ristorante
ğŸ²	pentola di cibo	cibo|ciotola di cibo|minestra|pentola di cibo|ristorante|stufato|zuppa
ğŸ³	cucinare	cibo|colazione allâ€™americana|cucinare|friggere|padella|padellino|ristorante|uova|uovo|uovo in padella
ğŸ´	forchetta e coltello	affamata|affamato|cena|che fame|cibo|cucinare|fame|forchetta e coltello|mangiare|posate|pranzo|ristorante
ğŸµ	tazza da tÃ¨ senza manico	bere|bevanda|pomeriggio|sete|tazza|tazza da tÃ¨ senza manico|tazza di tÃ¨|tazzina|tÃ¨
ğŸ¶	sakÃ¨	bar|bere|bevanda|bicchiere|bottiglia|bottiglia e bicchiere di sake|bottiglia e bicchiere di sakÃ¨|giapponese|ristorante|sake|sakÃ¨
ğŸ·	bicchiere di vino	alcool|bar|bere|bicchiere|bicchiere di vino|calice|enoteca|ristorante|vino
ğŸ¸	cocktail	alcol|alcolico|bar|bere|bevanda|bicchiere|bicchiere da cocktail|calice|cocktail|drink|ristorante
ğŸ¹	cocktail tropicale	alcool|bar|bere|club|cocktail|drink|ristorante|tropicale
ğŸº	boccale di birra	alcool|bar|bere|birra|boccale di birra|estate|Germania|octoberfest|pinta|pub|ristorante|sete
ğŸ»	boccali di birra	alcool|bar|birra|birre|boccali di birra che brindano|brindisi|celebrare|cin cin|festeggiare|pub|ristorante
ğŸ¼	biberon	bambina|bambino|bebÃ©|bere|biberon|bimba|bimbo|fame|latte|neonata|neonato|tenero
ğŸ¾	bottiglia stappata	auguri|bar|bere|brindisi|celebrare|champagne|congratulazioni|festeggiare|spumante|stappare|tappo
ğŸ¿	popcorn	cibo|cinema|mais|popcorn
ğŸ€	fiocco	auguri|bambina|bebÃ©|festa|fiocco|fiocco rosa|neonata
ğŸ	regalo	dono|festa|fiocco|Natale|pacchetto|regalino|regalo|sorpresa
ğŸ‚	torta di compleanno	auguri di compleanno|buon compleanno|candeline|cibo|compleanno|dolce|festa|festeggiare|pasticceria|tanti auguri|torta di compleanno|zucchero
ğŸƒ	zucca di Halloween	festa|Halloween|lanterna|zucca|zucca di Halloween
ğŸ„	albero di Natale	albero|albero di Natale|celebrare|festa|festeggiare|festoni|Natale|natura|palline|pino
ğŸ…	Babbo Natale	Babbo Natale|cappello|fest|festa|Natale|Santa Claus|uomo
ğŸ†	fuochi dâ€™artificio	boom|celebrazione|festa|fuochi dâ€™artificio|fuoco dâ€™artificio|luce|scintilla|stella
ğŸ‡	stellina scintillante	boom|esplosione|festa|fuoco|fuoco dâ€™artificio|stella filante|stellina scintillante|stelline scintillanti
ğŸˆ	palloncino	auguri|compleanno|festa|palloncino
ğŸ‰	spara coriandoli	auguri|compleanno|congratulazioni|coriandoli|evviva|felicitÃ |festa|party|spara coriandoli|stelle filanti|urrÃ |yahoo
ğŸŠ	coriandoli	carnevale|congratulazioni|coriandoli|decorazioni|evviva|festa|festeggiare|palla|palla di coriandoli|stelle filanti
ğŸ‹	albero di Tanabata	albero|albero decorato|albero di Tanabata|decorazioni|decorazioni di carta|festa|Festa delle stelle|giappone|giapponese|natura
ğŸŒ	bandiere del Giappone incrociate	bandiere|bandiere del Giappone incrociate|festa|festeggiamenti|Giappone|giapponese|giapponesi|incrociate
ğŸ	bambÃ¹ decorato	bambÃ¹|bambÃ¹ decorato|decorazione kadomatsu|festa|giapponese|pianta|pino
ğŸ	bambole giapponesi	bambole|festa|Festa delle bambole|giapponesi|Hina-matsuri|Hinamatsuri|imperatore|imperatore e imperatrice|imperatrice
ğŸ	aquilone a forma di carpa	aquilone|aquilone a forma di carpa|carpa|festa|giapponese|pesce
ğŸ	campana al vento	campana|campana al vento|campanelle|campanelle a vento|festa|scacciapensieri|vento
ğŸ‘	contemplazione della luna	contemplazione della luna|contemplazione festa|festa|festa della contemplazione della luna|festa della luna|festeggiare|luna
ğŸ’	zaino	accessori|campeggio|cartella|cartella di scuola|compiti|istruzioni|scuola|viaggiare|zainetto|zaino|zaino di scuola|zaino per la scuola
ğŸ“	cappello da laureato	cappello|cappello da laureato|festa|istruzione|laurea|laureata|laureato|universitÃ 
ğŸ 	cavallo da giostra	cavallino|cavallo|cavallo da giostra|giostra|infanzia|intrattenimento
ğŸ¡	ruota panoramica	intrattenimento|london eye|luna park|panoramica|parco divertimenti|parco giochi|ruota
ğŸ¢	montagne russe	intrattenimento|luna park|montagne|parco divertimenti|russe
ğŸ£	canna da pesca	canna da pesca|intrattenimento|lenza|pesca|pescare|pesce|sport
ğŸ¤	microfono	cantare|concerto|intrattenimento|Karaoke|microfono|musica|palco|presentare|spettacolo|teatro
ğŸ¥	cinepresa	cinema|cinepresa|film|filmare|hollywood|intrattenimento|registrare|telecamera
ğŸ¦	simbolo del cinema	cinema|cinepresa|film|filmare|hollywood|intrattenimento|simbolo del cinema|simbolo film
ğŸ§	cuffie	ascoltare|auricolari|cuffie|intrattenimento|musica|suono
ğŸ¨	tavolozza	arte|artista|colori|creativo|dipingere|palette|pittore|pittura|tavolozza|tavolozza dei colori
ğŸ©	cilindro	abbigliamento|bombetta|cappello|cilindro|elegante|inglese|intrattenimento|lincoln|mago
ğŸª	circo	circo|festa|fiera|intrattenimento|orfei|spettacolo|tenda|tenda da circo|tendone
ğŸ«	biglietto	ammissione|biglietto|cartellino|giallo|ingresso
ğŸ¬	ciak	ciak|ciak si gira|cinema|film|filmare|intrattenimento|lavagna|regista|scena|tavoletta
ğŸ­	maschere	arte|arti performative|carnevale|dietro le quinte|intrattenimento|maschere|palco|performance|recitare|scena|shakespeare|teatro
ğŸ®	gamepad	console|gamepad|giocare|gioco|joystick|videogioco
ğŸ¯	bersaglio	arciere|arco|bersaglio|colpire|freccette|gioco|sport|target|tiro con lâ€™arco
ğŸ°	slot machine	azzardo|casinÃ²|gioco|gioco dâ€™azzardo|scommesse|scommettere|slot|slot machine
ğŸ±	palla da biliardo	8|biliardo|giocare|gioco|otto|palla da biliardo|palla otto|sport
ğŸ²	dado	dadi|dado|gioco|gioco dei dadi
ğŸ³	bowling	birilli|bowling|giocare|gioco|palla|palla da bowling|sport
ğŸ´	carta da gioco Hanafuda	carta|carta da gioco|carta da gioco Hanafuda|carta dei fiori|giappone|giapponese|gioco|gioco di carte|Hanafuda
ğŸµ	nota musicale	canzone|musica|nota|nota musicale
ğŸ¶	note musicali	canzone|melodia|musica|nota|note|note musicali|spartito
ğŸ·	sassofono	blues|jazz|musica|sassofono|sax|strumento|strumento musicale|suonare
ğŸ¸	chitarra	band|basso|chitarra|corde|elettrica|musica|rock|strumento|strumento musicale|suonare
ğŸ¹	piano	classica|comporre|jazz|musica|piano|pianoforte|strumento|strumento musicale|suonare|tastiera
ğŸº	tromba	band|banda|blues|concerto|gruppo|jazz|musica|strumento|strumento musicale|tromba|trombone
ğŸ»	violino	musica|orchestra|strumento|strumento musicale|suonare|violino
ğŸ¼	pentagramma	chiave|chiave di violino|musica|partitura|pentagramma
ğŸ½	maglia da corsa	abbigliamento|correre|corsa|fascia|maglia|maglia da corsa|maglia da corsa con fascia|sport
ğŸ¾	tennis	giallo|palla|palla da tennis|pallina|pallina gialla|racchetta e palla da tennis|sport|tennis
ğŸ¿	sci	accessori|scarpone|scarpone da sci|sci|sport
ğŸ€	palla da pallacanestro	basket|basketball|canestro|canestro da basket|palla|palla da pallacanestro|pallacanestro|pallone|pallone da basket|sport
ğŸ	bandiera a scacchi	bandiera|bandiera a scacchi|circuito|corsa|gara|podio|scacchi|sport|vittoria
ğŸ‚	persona sullo snowboard	inverno|montagna|neve|omino in snowboard|persona|persona sullo snowboard|snowboard|sport|tavola|uomo sullo snowboard
ğŸƒ	persona che corre	correre|corsa|di corsa|gara|jogging|maratona|persona|persona che corre|sport
ğŸ„	persona che fa surf	mare|onde|persona|persona che fa surf|spiaggia|sport|surf|surfare|tavola
ğŸ…	medaglia sportiva	campione|corsa|gara|medaglia|medaglia sportiva|podio|risultato sportivo|sport|vincere|vittoria
ğŸ†	coppa	campione|coppa|premio|sport|trofeo|vincere|vincitore|vittoria
ğŸ‡	ippica	cavallo|cavallo da corsa|corse|fantino|galoppare|galoppo|ippica|sport|trotto
ğŸˆ	football americano	americano|football|palla|sport
ğŸ‰	pallone da rugby	palla|pallone|pallone da rugby|rugby|sport
ğŸŠ	persona che nuota	bracciata|gara|nuotare|nuotatore|nuoto|persona che nuota|sport|stile libero
ğŸ	cricket	cricket|gioco|mazza|palla|sport
ğŸ	palla da pallavolo	palla|palla da pallavolo|pallavolo|pallone|rete|sport|volley
ğŸ‘	hockey su prato	campo|hockey|hockey su prato|mazza|palla|partita|sport
ğŸ’	hockey su ghiaccio	ghiaccio|giocare|hockey su ghiaccio|hockey sul ghiaccio|mazza|mazza da hockey|puck|sport
ğŸ“	ping pong	giocare|gioco|pallina|ping pong|racchetta|rete|sport|tennis da tavolo|tennis tavolo
ğŸ 	casa	abitazione|casa|casa di campagna|casetta|edificio|fattoria|villetta
ğŸ¡	casa con giardino	abitazione|casa|casa con giardino|casa di campagna|casetta|edificio|giardino|nido|villa|villetta
ğŸ¢	edificio	edificio|edificio di uffici|edifico di uffici|palazzo|ufficio
ğŸ£	ufficio postale giapponese	edificio|giapponese|palazzo|posta|ufficio postale|ufficio postale giapponese
ğŸ¤	ufficio postale	edificio|europeo|posta|ufficio postale|ufficio postale europeo
ğŸ¥	ospedale	clinica|COVID|edificio|emergenza|infermiera|infermiere|malattia|medici|medicina|ospedale|pronto soccorso
ğŸ¦	banca	banca|denaro|edificio|finanza|mutuo|prelevare|soldi|wall street
ğŸ§	simbolo dello sportello bancomat	ATM|banca|bancomat|denaro|prelevare|simbolo dello sportello bancomat|soldi|spiccioli
ğŸ¨	hotel	albergo|edificio|hotel|palazzo
ğŸ©	love hotel	amore|edificio|hotel|love hotel|motel
ğŸª	minimarket	24 ore|autogrill|edificio|minimarket|negozio|negozio aperto 24 ore|supermercato
ğŸ«	scuola	alunni|classe|classi|edificio|imparare|insegnante|liceo|maestra|scuola|universitÃ 
ğŸ¬	grande magazzino	centro|commerciale|edificio|grande magazzino
ğŸ­	fabbrica	azienda|ciminiera|edificio|fabbrica|industria|industriale|inquinamento|produzione|stabile
ğŸ®	lanterna rossa	bar ristorante|cinese|giapponese|izakaya|lanterna|lanterna rossa|lanterne|luce|rosso
ğŸ¯	castello giapponese	asia|casa|castello|edificio|giappone|giapponese|palazzo
ğŸ°	castello	castello|edificio|fiaba|fiabe|palazzo
ğŸ´	bandiera nera	bandiera|bandiera che sventola|bandiera nera
ğŸ¸	badminton	badminton|giocare|gioco|racchetta|sport|volano
ğŸ¹	arco e freccia	arciere|arco|arco e freccia|cacciare|freccia|Sagittario|sport|tiratore dâ€™arco|tiro con lâ€™arco
ğŸº	anfora	acquario|anfora|ornamento|reperto|segno zodiacale|vaso
ğŸ€	ratto	animale|animali|fogna|ratto|topastro|topo
ğŸ	topo	animale|animali|cavia|topo|Topo|topolino
ğŸ‚	bue	animale|animali|bovini|bovino|bue|domestico|fattoria|segno zodiacale del toro|toro
ğŸƒ	bufalo dâ€™acqua	animale|animali|animali selvatici|bufalo|bufalo dâ€™acqua
ğŸ„	mucca	animale|animali|fattoria|latte|mucca|muu|vacca
ğŸ…	tigre	animale|animali|felino|predatore|tigre
ğŸ†	leopardo	animale|felino|leopardo|predatore|selvatico
ğŸ‡	coniglio	animale|animali|coniglietto|coniglio|domestico|fattoria
ğŸˆ	gatto	animale|cucciolo|domestico|gatta|gattina|gattino|miao|micino|micio
ğŸˆâ€â¬›	gatto nero	animale|felino|gatto|halloween|miao|micio|nero|sfiga|sfortuna
ğŸ‰	drago	animale|animali|cinese|drago|dragone|fiaba|game of thrones|mitologia|trono di spade
ğŸŠ	coccodrillo	animale|coccodrillo|lacrime di coccodrillo|rettile|selvatico
ğŸ‹	balena	animale|animali|balena|cetaceo|mare|oceano
ğŸŒ	lumaca	animale|giardino|lentezza|lento|lumachina|lumacone|natura
ğŸ	serpente	animale|animali|biscia|bosco|foresta|pericolo|selvatico|serpe|serpente|vipera
ğŸ	cavallo	animale|cavallo|cavallo da corsa|corsa|corse|fattoria|galoppo|polo|ranch|trotto
ğŸ	montone	animale|animali|ariete|fattoria|montone|ovino|pecora|segno zodiacale dellâ€™ariete
ğŸ	capra	animale|animali|capra|capricorno|fattoria|latte|segno zodiacale del capricorno
ğŸ‘	pecora	animale|beeh|campagna|contare le pecore|fattoria|lana|montone|morbido|notte|pecorella|pecorone|soffice
ğŸ’	scimmia	animale|scimmietta|selvatico
ğŸ“	gallo	alba|animale|animali|domestico|fattoria|galletto|gallo|mattino|uccello
ğŸ”	gallina	animale|animali|fattoria|galletto|gallina|gallo|pollo|uccello
ğŸ•	cane	abbaiare|animale|animale domestico|animali|cagnolino|cane|cucciolo
ğŸ•â€ğŸ¦º	cane da assistenza	accessibilitÃ |animale|cane|cane dâ€™assistenza|cane da assistenza|cane da salvataggio|cane di servizio|cane guida
ğŸ–	maiale	animale|animali|fattoria|maiale|scrofa
ğŸ—	cinghiale	animale|animali|bosco|cinghiale|faccina cinghiale|game of thones|maiale selvatico
ğŸ˜	elefante	animale|elefante|savana|selvatico
ğŸ™	polpo	animale|animali|mare|oceano|polipo|polpo
ğŸš	conchiglia	animale|conchiglia|conchiglia a spirale|mare|oceano|spiaggia
ğŸ›	insetto	animale|bruco|giardino|millepiedi
ğŸœ	formica	animale|formica|formichina|insetto|lavorare
ğŸ	ape	animale|bombo|giardino|insetto|miele|natura|primavera|regina|vespa
ğŸ	coccinella	animale|fortuna|giardino|insetto|natura
ğŸŸ	pesce	animale|animali|mare|oceano|pesce|pesci|segno zodiacale dei Pesci
ğŸ 	pesce tropicale	animale|animali|mare|oceano|pesce|pesce tropicale
ğŸ¡	pesce palla	animale|animali|mare|oceano|pesce|pesce palla|tropici
ğŸ¢	tartaruga	animale|animali|lenta|lentezza|lento|tartaruga
ğŸ£	pulcino che nasce	animale|cucciolo|gallina|nascita|pulcino|schiudere|uccello|uovo|uovo che si schiude
ğŸ¤	pulcino	animale|animali|cucciolo|faccina pulcino|gallina|pulcino
ğŸ¥	pulcino visto di fronte	animale|baby shower|bambino|bebÃ¨|bimbo|cucciolo|fattoria|galletto|gallina|neonato|ornitologia|piccolo
ğŸ¦	uccello	animale|ornitologia|passerotto|uccellino
ğŸ¦â€â¬›	merlo	animale|cornacchia|corvo|merlo|nero|uccello
ğŸ¦â€ğŸ”¥	fenice	fantasia|fenice|immortale|mitologia|personaggio|reincarnazione|reinventarsi|rinascita|trasformazione|uccello di fuoco
ğŸ§	pinguino	animale|antartico|ornitologia|polo sud|uccello
ğŸ¨	koala	animale|animali|Australia|faccina koala|koala|selvatico
ğŸ©	barboncino	animale|cane|pelo|razza|soffice
ğŸª	dromedario	Africa|animale|animali|cammello|deserto|dromedario|gobba|gobbe|trasporto
ğŸ«	cammello	animale|animali|cammello|deserto|due gobbe|gobba
ğŸ¬	delfino	animale|cetaceo|delfino|mare|oceano|spiaggia
ğŸ­	muso di topo	animale|faccina|muso di topo|topo|topolino
ğŸ®	muso di mucca	animale|animali|faccina|fattoria|mucca|muso di mucca|muu
ğŸ¯	muso di tigre	animale|animali|faccina|felino|muso di tigre|tigre
ğŸ°	muso di coniglio	animale|animale domestico|animali|coniglietto|coniglio|faccina|muso di coniglio
ğŸ±	muso di gatto	animale|animali|faccina|gatto|muso di gatto
ğŸ²	testa di drago	animale|animali|drago|dragone|faccina|fiaba|testa di drago
ğŸ³	balena che spruzza acqua	animale|animali|balena|balena che spruzza acqua|balenottera|cetaceo|mare|oceano|spruzzare
ğŸ´	muso di cavallo	animale|campagna|cavallino|cowboy|dressage|equino|faccina|far west|fattoria|rampante
ğŸµ	muso di scimmia	animale|faccina|scimmia|scimmietta
ğŸ¶	muso di cane	animale|cagnolino|cane|cucciolo|domestico|faccina
ğŸ·	muso di maiale	animale|animali|faccina|fattoria|maiale|maialino|muso di maiale|natura|pancetta|porchetta
ğŸ¸	rana	animale|bosco|fiaba|lago|muso di rana|natura|principe|raganella|ranocchia|ranocchio|rospo|stagno
ğŸ¹	criceto	animale|animali|criceto|domestico|faccina|muso di criceto
ğŸº	lupo	animale|bosco|faccina|favola|fiaba|lupo mannaro|muso di lupo|selvatico
ğŸ»	orso	animale|faccina|muso di orso|orsacchiotto|orsetto|orso
ğŸ¼	panda	animale|animali|bamboo|faccina|muso di panda|panda|WWF
ğŸ½	naso da maiale	animale|animali|faccina|maiale|maialino|naso|naso da maiale
ğŸ¾	impronte di zampe	animale|cane|impronta|impronta di zampa|impronte|impronte di zampe|zampa|zampe|zampine
ğŸ‘€	occhi	corpo|faccia|guardare|occhi|osservare|vedere
ğŸ‘‚	orecchio	ascoltare|ascolto|corpo|orecchie|orecchio|sentire|sento|ti ascolto|ti sto ascoltando
ğŸ‘ƒ	naso	annusare|corpo|faccia|ficcanaso|fiutare|naso|odore|profumo
ğŸ‘„	bocca	bacio|bocca|corpo|faccia|labbra|rossetto|sexy|smack
ğŸ‘…	lingua	corpo|faccia|lingua|linguaccia|slurp
ğŸ‘†	indice alzato	dito|dito alzato|dito in su|dito indice|in alto|indice alzato|indice in su|mano|sÃ¹
ğŸ‘‡	indice abbassato	dito|dito abbassato|dito in giÃ¹|dito indice|indicare|indice abbassato|indice in giÃ¹|mano|qui|sotto
ğŸ‘ˆ	indice verso sinistra	direzione|dito|dito verso sinistra|indicare|indice|indice verso sinistra|lÃ |mano|sinistra
ğŸ‘‰	indice verso destra	a destra|destra|di lÃ |dito|dito indice|dito verso destra|indicare|indice verso destra|mano
ğŸ‘Š	pugno chiuso	dâ€™accordo|mano|ok|patto|pugno|pugno chiuso|rock|sÃ¬
ğŸ‘‹	mano che saluta	a dopo|ci sei?|ci vediamo|ciao|ciaone|gesto di saluto|mano|mano aperta|mano che saluta|salutare|schiaffo
ğŸ‘Œ	mano che fa OK	bene|capito|dâ€™accordo|dito|gesto di ok|ho capito|indice e pollice|mano che fa OK|OK con la mano|segno di OK|va bene
ğŸ‘	pollice in su	+1|bene|capito|certo|dâ€™accordo|dito|mi piace|ok|perfetto|pollice in su|sÃ¬|va bene
ğŸ‘	pollice verso	giÃ¹|in basso|mano|no|non mi piace|pollice|pollice abbassato|pollice in giÃ¹|pollice verso|segno
ğŸ‘	mani che applaudono	applaudire|applauso|bravo|clap clap|complimenti|congratulazioni|mani che applaudono|ok|pregare|preghiera|segno|yeah
ğŸ‘	mani aperte	abbracciare|abbraccio|accogliere|aperta|aperte|mani|mano|segno|segno delle mani aperte
ğŸ‘‘	corona	abbigliamento|corona|famiglia reale|medioevo|principe|principessa|re|regale|regina|vincere
ğŸ‘’	cappello da donna	abbigliamento|abbigliamento donna|accessori|cappellino di paglia|cappello|cappello da donna|fiocco
ğŸ‘“	occhiali da vista	abbigliamento|nerd|occhiali|occhiali da vista
ğŸ‘”	cravatta	abbigliamento|abbigliamento uomo|camicia|camicia a righe|colletto|cravatta|vestiti da uomo
ğŸ‘•	t-shirt	abbigliamento|abbigliamento informale|casual|colletto|maglia|maglietta|maniche corte|polo|shopping|t-shirt
ğŸ‘–	jeans	abbigliamento|blu|casual|denim|jeans|pantaloni|vestiti
ğŸ‘—	vestito	abbigliamento|abito|donna|elegante|vestiti|vestito
ğŸ‘˜	kimono	abbigliamento|giappone|kimono|vestito
ğŸ‘™	bikini	abbigliamento|bikini|costume|costume da bagno|costume due pezzi|estate|mare|piscina|spiaggia
ğŸ‘š	maglietta da donna	abbigliamento|donna|maglietta|maglietta da donna|maglietta rosa|polo|t-shirt|vestiti|vestiti da donna
ğŸ‘›	borsellino	abbigliamento|accessori|borsellino|borsetta|denaro|elegante|moneta|porta monete|portafogli|shopping|soldi
ğŸ‘œ	borsa	abbigliamento|borsa|borsetta|shopping|valigia
ğŸ‘	pochette	abbigliamento|accessori|borsa|borsetta|elegante|pochette
ğŸ‘	scarpa da uomo	abbigliamento|accessori|mocassino|scarpa|scarpa da uomo|shopping|uomo
ğŸ‘Ÿ	scarpa sportiva	abbigliamento|accessori|correre|corsa|scarpa|scarpa da ginnastica|scarpa sportiva|scarpe|scarpe da corsa|scarpe da tennis|sneaker|tennis
ğŸ‘ 	scarpa con il tacco	abbigliamento|decolletÃ©|donna|moda|scarpa|scarpa con il tacco|stiletto|tacco
ğŸ‘¡	sandalo da donna	abbigliamento|accessori|donna|sandalo|sandalo da donna|scarpa
ğŸ‘¢	stivale da donna	abbigliamento|donna|scarpa|scarpe|stivale|stivale da donna|stivaletto
ğŸ‘£	impronta di piedi	camminare|corpo|impronta|impronta di piedi|impronte|passi|passo|piede|piedi|piedi nudi
ğŸ‘¤	profilo di persona	busto|mistero|nascosto|ombra|persona|profilo|profilo di persona|sagoma|silhouette
ğŸ‘¥	profilo di due persone	amici|due|due utenti|mistero|ombra|ombre|persona|persone|profili|profilo|profilo di due persone|silhouette
ğŸ‘¦	bambino	bambino|bimbo|giovane|persona|persone|ragazzino|tenero
ğŸ‘§	bambina	bambina|bimba|bionda|codini|contenta|felice|persona|persone|ragazzina|treccine
ğŸ‘¨	uomo	amico|biondo|fratello|maschio|papÃ |persona|persone|ragazzo|uomo
ğŸ‘¨â€ğŸŒ¾	contadino	allevatore|campagna|cappello|contadino|fattoria|giardino|lavoro|uomo
ğŸ‘¨â€ğŸ³	cuoco	chef|cucina|cucinare|cuoco|lavoro|ristorante|uomo
ğŸ‘¨â€ğŸ¼	uomo che allatta	allattamento|amore|babysitter|bebÃ¨|neonato|nutrire|padre|papÃ |persona|uomo|uomo che allatta
ğŸ‘¨â€ğŸ“	studente maschio	istruzione|laurea|laureato|maschio|ragazzo|studente|universitÃ |uomo
ğŸ‘¨â€ğŸ¤	cantante uomo	attore|cantante|lavoro|musica|rock star|star|uomo|ziggy
ğŸ‘¨â€ğŸ¨	artista uomo	arte|artista|dipingere|lavoro|pittore|uomo
ğŸ‘¨â€ğŸ«	professore	insegnante|insegnare|lavoro|maestro|professore|scuola|studio|uomo
ğŸ‘¨â€ğŸ­	operaio	fabbrica|industria|lavoro|operaio|saldatore|tuta blu|uomo
ğŸ‘¨â€ğŸ’»	tecnologo	computer|high tech|lavoro|programmatore|sviluppatore|tecnologia|tecnologo|uomo
ğŸ‘¨â€ğŸ’¼	impiegato	architetto|business|impiegato|lavoro|manager|ufficio|uomo
ğŸ‘¨â€ğŸ”§	meccanico uomo	chiave inglese|idraulico|lavoro|meccanico|operaio|tecnico specializzato|tuta blu|uomo
ğŸ‘¨â€ğŸ”¬	scienziato	biologia|biologo|camice|chimica|lavoro|scienza|scienziato|uomo
ğŸ‘¨â€ğŸš€	astronauta uomo	astronauta|astronauta maschio|lavoro|razzo|scienza|spazio|universo|uomo
ğŸ‘¨â€ğŸš’	pompiere uomo	fuoco|incendio|lavoro|pompiere|pompiere maschio|uomo|vigile del fuoco
ğŸ‘¨â€ğŸ¦¯	uomo con bastone bianco di orientamento	accessibilitÃ |cecitÃ |cieco|ipovedente|ipovedenti|non vedente|non vedenti|persona|uomo|uomo con bastone bianco di orientamento|uomo con bastone per ciechi
ğŸ‘¨â€ğŸ¦¼	uomo su sedia a rotelle motorizzata	accessibilitÃ |disabile|persona|sedia a rotelle|uomo|uomo in carrozzina|uomo in sedia a rotelle|uomo su sedia a rotelle motorizzata
ğŸ‘¨â€ğŸ¦½	uomo su sedia a rotelle manuale	accessibilitÃ |disabile|persona|uomo|uomo in carrozzina|uomo in sedia a rotelle|uomo su sedia a rotelle manuale
ğŸ‘©	donna	bionda|capelli|donna|femmina|persona|persone|ragazza|viso
ğŸ‘©â€ğŸŒ¾	contadina	allevatrice|campagna|cappello|contadina|donna|fattoria|giardino|lavoro
ğŸ‘©â€ğŸ³	cuoca	chef|cucina|cucinare|cuoca|donna|lavoro|ristorante
ğŸ‘©â€ğŸ¼	donna che allatta	allattamento|amore|babysitter|bebÃ¨|donna|donna che allatta|madre|mamma|neonato|nutrire|persona
ğŸ‘©â€ğŸ“	studentessa	donna|femmina|istruzione|laurea|laureata|ragazza|studente|studentessa|universitÃ 
ğŸ‘©â€ğŸ¤	cantante donna	attrice|cantante|donna|lavoro|musica|rock star|star|ziggy
ğŸ‘©â€ğŸ¨	artista donna	arte|artista|dipingere|donna|lavoro|pennello|pittrice
ğŸ‘©â€ğŸ«	professoressa	donna|insegnante|insegnare|lavoro|maestra|professoressa|scuola|studio
ğŸ‘©â€ğŸ­	operaia	donna|fabbrica|industria|lavoro|operaia|saldatrice|tuta blu
ğŸ‘©â€ğŸ’»	tecnologa	computer|donna|high tech|lavoro|programmatrice|sviluppatrice|tecnologa|tecnologia
ğŸ‘©â€ğŸ’¼	impiegata	architetto|business|donna|impiegata|lavoro|manager|ufficio
ğŸ‘©â€ğŸ”§	meccanico donna	chiave inglese|donna|idraulico|lavoro|meccanico|meccanico femmina|operaia|tecnico specializzato|tuta blu
ğŸ‘©â€ğŸ”¬	scienziata	biologa|biologia|camice|chimica|donna|lavoro|scienza|scienziata
ğŸ‘©â€ğŸš€	astronauta donna	astronauta|astronauta femmina|donna|lavoro|razzo|scienza|spazio
ğŸ‘©â€ğŸš’	pompiere donna	donna|fuoco|incendio|lavoro|pompiere|pompiere femmina|vigile del fuoco
ğŸ‘©â€ğŸ¦¯	donna con bastone bianco di orientamento	accessibilitÃ |cecitÃ |cieca|donna|donna con bastone bianco di orientamento|donna con bastone per ciechi|donna non vedente|ipovedente|ipovedenti|non vedente|non vedenti|persona
ğŸ‘©â€ğŸ¦¼	donna su sedia a rotelle motorizzata	accessibilitÃ |disabile|donna|donna in carrozzina|donna in sedia a rotelle|donna su sedia a rotelle motorizzata|persona|sedia a rotelle
ğŸ‘©â€ğŸ¦½	donna su sedia a rotelle manuale	accessibilitÃ |disabile|donna|donna in carrozzina|donna in sedia a rotelle|donna su sedia a rotelle manuale|persona|sedia a rotelle
ğŸ‘ª	famiglia	bambino|famiglia|mamma|papÃ |persone
ğŸ‘«	uomo e donna che si tengono per mano	amore|coppia|donna e uomo|famiglia|innamorati|per mano|persone|tenersi per mano|uomo e donna che si tengono per mano|uomo e donna per mano
ğŸ‘¬	due uomini che si tengono per mano	bff|compagni|coppia|due uomini che si tengono per mano|fidanzati|gemelli|innamorati|oroscopo|persone|tenersi per mano|uomo|zodiaco
ğŸ‘­	due donne che si tengono per mano	amiche|amicizia|bambine|bff|coppia|darsi la mano|due donne che si tengono per mano|legame|migliori amiche|persone|ragazze|sorelle
ğŸ‘®	agente di polizia	agente|arresto|controllo|fermo|polizia
ğŸ‘¯	persone con orecchie da coniglio	amicizia|anima gemella|ballare|festa|orecchie da coniglio|party|persone con orecchie da coniglio|uguali
ğŸ‘°	persona con velo	abito|bianco|matrimonio|persona con velo|velo
ğŸ‘±	persona bionda	biondo|capelli biondi|persona|persona bionda
ğŸ‘²	uomo con zucchetto cinese	cappello|cinese|uomo|uomo con zucchetto|uomo con zucchetto cinese|zucchetto
ğŸ‘³	persona con turbante	persona|persona con turbante|turbante
ğŸ‘´	uomo anziano	anziano|capelli|nonnino|nonno|pelato|perdere i capelli|persona|persone|saggio|uomo|vecchietto|vecchio
ğŸ‘µ	donna anziana	anziana|capelli|capelli bianchi|donna|nonna|nonnina|persone|saggezza|saggia|signora|vecchia|vecchietta
ğŸ‘¶	neonato	bambino|bebÃ¨|faccia|famiglia|figlio|giovane|neonato|persone|piccolo
ğŸ‘·	operaio edile	casco|costruire|costruzioni|edile|ingegnere|lavoratore|muratore|operaio|tuta blu|uomo
ğŸ‘¸	principessa	comandare|corona|donna|favola|fiaba|monarca|principessa|reale|regina|sovrana
ğŸ‘¹	orco	creature|diavolo|faccina|favola|fiaba|finzione|maschera|mostro|orco|paura
ğŸ‘º	goblin	arrabbiato|carnevale|cattivo|crudele|diavolo|favola|fiaba|folletto|goblin|malefico|mostro
ğŸ‘»	fantasma	creatura|fantasmino|favola|fiaba|halloween|horror|mostro|paura|scherzetto|scherzo|sciocco|storie di fantasmi|stregare|stregato|terrore
ğŸ‘¼	angioletto	angelo|angioletto|bambina|bambino|bimba|bimbo|chiesa|faccina|favola|fiaba|persona|santo
ğŸ‘½	alieno	alieno|ET|extraterrestre|faccina|favola|marziani|mostro|spazio|UFO
ğŸ‘¾	mostro alieno	alieno|arcade|creatura|faccina|faccina viola|favola|GIF|mostro|pixel|UFO|video gioco|videogioco
ğŸ‘¿	faccina arrabbiata con corna	arrabbiato|diavoletto|diavolo|diavolo viola|faccina|faccina arrabbiata con corna|scontento
ğŸ’€	teschio	cranio|favola|morte|mostro|ossa|pericolo|stanco morto|teschio|umorismo nero|yolo
ğŸ’	persona con mano capovolta	aiuto|capovolgere la mano|gesto con i capelli|gossip|informazioni|mano|mano allâ€™insÃ¹|pettegolezzo|sarcasmo|sfacciataggine|sul serio
ğŸ’‚	guardia	buckingham palace|guardia|guardia reale|lavoro|londra|sentinella|turno di guardia|uomo
ğŸ’ƒ	donna che balla	ballare|ballerina|ballo|donna|donna che balla|flamenco|lavoro|olÃ©|salsa|tango
ğŸ’„	rossetto	appuntamento|bellezza|cosmetici|make up|makeup|rossetto|rosso|serata|trucco
ğŸ’…	smalto per unghie	cosmetici|make up|manicure|noia|smalto|smalto per unghie|spa|unghie|unghie con smalto
ğŸ’†	persona che riceve un massaggio	centro estetico|estetista|faccia|mal di testa|massaggio|massaggio facciale|persona che riceve un massaggio|relax|spa|testa
ğŸ’‡	taglio di capelli	acconciatura|bellezza|capelli|parrucchiera|parrucchiere|persona|salone|salone di bellezza|tagliare|taglio|taglio di capelli
ğŸ’ˆ	barbiere	barbiere|insegna
ğŸ’‰	siringa	ago|dottore|iniezione|malato|medicina|medico|ospedale|puntura|sangue|siringa|vaccinazione|vaccino
ğŸ’Š	pillola	dottore|farmaco|malato|malattia|medicina|pillola|pillole|vitaminca
ğŸ’‹	impronta della bocca	bacio|impronta della bocca|labbra|romanticismo|romantico|rossetto|segno delle labbra|sexy
ğŸ’Œ	lettera dâ€™amore	busta|busta con cuore|câ€™Ã¨ posta per te|cuore|inviare|lettera|lettera dâ€™amore|posta|ricevere|romanticismo|san valentino
ğŸ’	anello	brillante|diamante|fidanzamento|fidanzarsi|fidanzata|fidanzato|gioielli|gioiello|matrimonio|romanticismo undefined
ğŸ’	gemma	diamante|fidanzamento|gemma|gioiello|per sempre|pietra preziosa|romanticismo|romantico|soldi
ğŸ’	bacio tra coppia	amore|appuntamento|baciarsi|bacio|bacio tra coppia|coppia|coppietta|fidanzati|persone|romanticismo|romantico
ğŸ’	mazzo di fiori	anniversario|appuntamento|bouquet|compleanno|fioraio|fiore|fiori|natura|regalo|romanticismo|romantico
ğŸ’‘	coppia con cuore	amore|anniversario|bacio|coppia|coppia con cuore|cuore|innamorati|insieme|persone|romanticismo
ğŸ’’	chiesa per matrimonio	amore|cappella|chiesa|chiesa per matrimonio|matrimonio|nozze|religione|romanticismo|sposarsi
ğŸ’“	cuore che batte	amore|battito|cuore|cuore che batte|cuore rosa|emozione|pulsazione
ğŸ’”	cuore infranto	amore|amore finito|cuore|emozione|infranto|spezzato|triste
ğŸ’•	due cuori	amare|amore|anniversario|appuntamento|baci|cuori|due cuori|emozione|flirt|innamorato|romantico|rosa
ğŸ’–	cuore che luccica	amore|cuore|cuore che luccica|cuore rosa|emozionato|emozione|innamorata|innamorato|luccicare|luccichio
ğŸ’—	cuore che cresce	amore|battito|cuore|cuore che batte|cuore che cresce|cuore che pulsa|cuore rosa|emozionato|emozione|nervoso
ğŸ’˜	cuore con freccia	amore|appuntamento|cuore con freccia|cupido|emozione|emozioni|freccia|innamorarsi|innamorati|romantico|rosa|san valentino
ğŸ’™	cuore blu	amore|azzurro|blu|cuore|emozione
ğŸ’š	cuore verde	amore|cuore|emozione|verde
ğŸ’›	cuore giallo	amore|cuore|emozione|giallo|innamorato
ğŸ’œ	cuore viola	amore|cuore|emozione|viola
ğŸ’	cuore con fiocco	amore|cuore|cuore con fiocco|cuore rosa|cuore rosa con fiocco|emozione|fiocco|regalo|romantico|San Valentino
ğŸ’	cuori che girano	adorabile|amore|appuntamento|carino|cuori che girano|cuoricini|cuoricino|emozione|girare
ğŸ’Ÿ	decorazione con cuore	amore|cuore|cuore bianco|cuore nel quadrato|cuore viola|cuoricino|decorazione con cuore|san valentino|ti amo
ğŸ’ 	petalo di fiore	carino|decorazione|diamante|emozione|fiore|forma di diamante|geometria|petalo di fiore
ğŸ’¡	lampadina	brillante|elettrica|elettricitÃ |eureka|fumetto|geniale|idea|lampadina|luce
ğŸ’¢	rabbia	arrabbiato|emozione|fumetto|rabbia|simbolo
ğŸ’£	bomba	bomba|boom|emozione|esplosione|fumetto|pericolo
ğŸ’¤	sonno	dormire|dormita|fumetto|ho sonno|pisolino|russare|sonnellino|sonno|stanco|Zzz
ğŸ’¥	collisione	bomba|boom|collisione|emozione|esplodere|esplosione|fumetto|simbolo collisione
ğŸ’¦	gocce di sudore	acqua|allenamento|fumetto|gocce|gocciolare|schizzo|sudata|sudato|sudore
ğŸ’§	goccia	acqua|freddo|fumetto|goccia|lacrima|natura|sudore|triste
ğŸ’¨	nuvola di polvere	andare|correre|emozione|fuga|fumetto|fumo|nuvola di polvere|scappare|soffio|vento
ğŸ’©	cacca	buona fortuna|cacca|fortuna|fortunato|popÃ²|pupÃ¹|puzza
ğŸ’ª	bicipite	bicipite|bodybuilding|braccio piegato|corpo|forte|forza|fumetto|muscolo|palestra|pesi|sollevamento|teso
ğŸ’«	stella con scia	fumetto|stella cadente|stella con scia|vertiginoso|vorticoso
ğŸ’¬	fumetto	dialogo|fumetto|mmm|nuvoletta|parlare|puntini|sospensione|sta scrivendo|sto scrivendo|testo
ğŸ’­	nuvoletta	fumetto|idea|inventare|nuvola|pensare|realizzare|riflettere|sognare a occhi aperti
ğŸ’®	fiore bianco	fiore|fiore bianco|fiorellino|simbolo ben fatto
ğŸ’¯	100 punti	100|cento|dâ€™accordo|massimo|punteggio|punteggio pieno|punti|sicuro|tutto
ğŸ’°	sacco di soldi	banca|borsa|contanti|denaro|dollari|oro|pagare|ricchezza|ricco|sacco per soldi|soldi|tesoro
ğŸ’±	cambio valuta	banca|cambio|cambio di valuta|denaro|finanza|mercati|mercato|soldi|valuta
ğŸ’²	Dollaro	cash|contanti|denaro|dollaro|pagare|simbolo del dollaro|soldi|valuta
ğŸ’³	carta di credito	addebito|banca|carta|carta di credito|credito|denaro|pagare|soldi
ğŸ’´	banconota Yen	banca|banconota|denaro|Giappone|soldi|valuta|Yen
ğŸ’µ	banconota Dollaro	banca|banconota|banconote|contanti|denaro|Dollaro|moneta|soldi|valuta
ğŸ’¶	banconota Euro	banca|banconota|cash|crisi|denaro|Euro|millionario|soldi|valuta
ğŸ’·	banconota Sterlina	banconote|brexit|cash|denaro|Gran Bretagna|millionario|pound|ricco|soldi|Sterlina|UK|valuta
ğŸ’¸	soldi con le ali	banconota|banconota con le ali|soldi|soldi che volano|soldi con le ali
ğŸ’¹	grafico ascendente	ascendente|banca|crescita|finanza|grafico yen in rialzo|in rialzo|mercati|mercato in salita|rialzo|trend|valute|yen
ğŸ’º	sedile	sedia|sedile
ğŸ’»	computer portatile	computer|notebook|PC|personal|portatile
ğŸ’¼	valigetta 24 ore	24 ore|borsa|documenti|lavoro|porta documenti|ufficio|valigetta|valigetta 24 ore
ğŸ’½	minidisc	CD|computer|disc|disco|lettore|MD|mini disc|minidisc
ğŸ’¾	floppy disc	computer|disc|dischetto|floppy
ğŸ’¿	disco ottico	blu-ray|CD|computer|disco|disco ottico|DVD
ğŸ“€	DVD	blu ray|blu-ray|computer|computer disk|disco|DVD
ğŸ“	cartella file	archiviare|archivio|cartella|computer|file|ufficio
ğŸ“‚	cartella aperta	aperta|cartella|file
ğŸ“ƒ	pagina con piega	carta|documento|lettera|pagina|pagina arricciata|pagina con piega|ufficio
ğŸ“„	pagina	carta|di fronte|documento|fronte|lettera|pagina|pagina di fronte|ufficio
ğŸ“…	calendario	17|calendario|data|diciasette|giorno|ricorrenza|sfortuna|venerdÃ¬ 17
ğŸ“†	calendario a strappo	calendario|calendario a strappo|quando|tempo|venerdÃ¬ 17
ğŸ“‡	schedario	contatti|rolodex|Rolodex|schedario|schedario girevole|schedario rotante|ufficio|vintage
ğŸ“ˆ	grafico con andamento positivo	andamento ascendente|ascendente|aumentare|aumento|crescere|crescita|finanza|grafico|grafico con andamento positivo|linea|trend
ğŸ“‰	grafico con andamento negativo	andamento discendente|calo|crisi|discendente|economia|finanza|grafico|grafico con andamento negativo|trend
ğŸ“Š	grafico a barre	barre|dati|grafico|grafico a barre|statistica
ğŸ“‹	portablocco	appunti|blocco|blocco note|cartella|portablocco|tavoletta
ğŸ“Œ	puntina	collage|puntina|puntina da disegno|scuola|ufficio
ğŸ“	puntina arrotondata	localitÃ |mappa|pin|posizione|puntina|puntina arrotondata|puntina da disegno|spillo|ufficio
ğŸ“	graffetta	clippy|fermaglio|graffa|graffetta|paperclip|ufficio
ğŸ“	righello	geometria|matematica|misurare|riga|righello|scuola|strumento|studiare
ğŸ“	squadra	angoli|geometria|matematica|misurare|righello|scuola|squadra|triangolo
ğŸ“‘	etichette segnalibro	etichette segnalibro|linguette|segnalibro|ufficio
ğŸ“’	quaderno ad anelli	annotazioni|appunti|blocco|block notes|libro mastro|note|quaderno|quaderno ad anelli|registro|registro scolastico|scuola|taccuino
ğŸ““	quaderno	appunti|biblioteca|libreria|libro|libro grigio|prendere nota|quaderno|taccuino|ufficio
ğŸ“”	quaderno con copertina decorata	album|album delle foto|compiti|copertina|fotoalbum|quaderno con copertina decorata|scuola|taccuino|taccuino con decorazione|taccuino copertina decorata|taccuino decorato|universitÃ 
ğŸ“•	libro chiuso	biblioteca|istruzione|leggere|libreria|libro|libro chiuso|rosso|scuola|studiare|universitÃ 
ğŸ“–	libro aperto	compiti|istruzione|leggere|libreria|libro|libro aperto|romanzo|scuola
ğŸ“—	libro verde	biblioteca|compiti|istruzione|libreria|libro|libro verde|quaderno|scuola
ğŸ“˜	libro blu	biblioteca|compiti|istruzione|leggere|libreria|libro|libro blu|quaderno|quaderno blu|scuola|studiare
ğŸ“™	libro arancione	biblioteca|compiti|istruzione|leggere|libreria|libro|libro arancione|quaderno|scuola|studiare
ğŸ“š	libri	biblioteca|compiti|doposcuola|leggere|libreria|libri|pila di libri|quaderni|romanzi|scuola|studiare|universitÃ 
ğŸ“›	tesserino per nome	badge|etichetta|etichetta a tulipano|giappone|giapponese|nome|tesserino|tesserino per nome|tulipano
ğŸ“œ	pergamena	decreto|documento|laurea|lettera|mappa|pergamena|rotolo|rotolo di carta
ğŸ“	memo	appunti|blocco note|block notes|comunicazione|matita|memo|nota|scrivere|taccuino
ğŸ“	cornetta	chiamami|chiamare|comunicazione|cornetta|cornetta del telefono|fisso|telefonare|telefono|ti chiamo|ti richiamo
ğŸ“Ÿ	cercapersone	cercapersone|comunicazione|lavoro
ğŸ“ 	fax	computer|comunicazione|fax|periferiche|stampante|ufficio
ğŸ“¡	antenna satellitare	antenna|antenna parabolica|antenne paraboliche|antenne satellitari|comunicazione|parabola|satellitare|satellite|scienza|scienze|tecnologia
ğŸ“¢	altoparlante	audio|comunicazione|megafono|parlare in pubblico|speaker|suono|volume
ğŸ“£	megafono	altoparlante|altoparlanti|comunicazione|megafoni|megafono|parlare|suono|tifare|tifo|urlare
ğŸ“¤	posta inviata	comunicazione|in uscita|inviata|posta|posta in uscita|vaschetta
ğŸ“¥	posta ricevuta	comunicazione|email|in arrivo|posta|posta in arrivo|ricevuta|vaschetta
ğŸ“¦	pacco	cartone|collo|consegna|pacco|scatola|scatolone|spedizione
ğŸ“§	e-mail	busta|comunicazione|e-mail|email|inviare|lettera|mail|posta|posta elettronica|ricevere
ğŸ“¨	posta in arrivo	busta|comunicazione|consegna|consegnare|e-mail|email|in arrivo|lettera|mail|posta|posta in arrivo|posta ricevuta
ğŸ“©	posta in uscita	busta|busta con freccia|comunicazione|email|in uscita|lettera|mail|posta|posta in uscita|posta inviata
ğŸ“ª	cassetta postale chiusa bandierina abbassata	bandierina|buca delle lettere|casella postale|cassetta postale|cassetta postale chiusa bandierina abbassata|cassetta postale chiusa bandierina giÃ¹|chiusa|email|inviare|mail|posta|ricevere
ğŸ“«	cassetta postale chiusa bandierina alzata	bandierina|buca delle lettere|cassetta postale|cassetta postale chiusa bandierina alzata|cassetta postale chiusa bandierina su|chiusa|comunicazione|email|inviare|mail|posta|ricevere
ğŸ“¬	cassetta postale aperta bandierina alzata	aperta|bandierina|buca delle lettere|cassetta postale|cassetta postale aperta bandierina alzata|cassetta postale aperta bandierina su|mail|posta
ğŸ“­	cassetta postale aperta bandierina abbassata	aperta|bandierina|buca delle lettere|cassetta postale|cassetta postale aperta bandierina abbassata|cassetta postale aperta bandierina giÃ¹|cassetta postale con bandierina abbassata|consegna|inviare|mail|posta|ricevere
ğŸ“®	cassetta delle lettere	buca delle lettere|câ€™Ã¨ posta per te|cassetta delle lettere|inviare|lettera|posta|poste|ricevere|spedire
ğŸ“¯	corno postale	cornetta da postiglione|cornetto postale|corno|nuovo messaggio|postale|tromba|trombone
ğŸ“°	quotidiano	giornale|notizia|quotidiano
ğŸ“±	telefono cellulare	cellulare|chiamare|comunicare|smartphone|telefono
ğŸ“²	telefono cellulare con freccia	cellulare|cellulare con freccia|chiamami|chiamare|ricevere|smartphone|telefonare|telefono|telefono cellulare con freccia
ğŸ“³	modalitÃ  vibrazione	cellulare|modalitÃ  telefono|modalitÃ  vibrazione|telefono|telefono modalitÃ 
ğŸ“´	cellulare spento	cellulare|off|simbolo|spento|telefono
ğŸ“µ	simbolo che vieta lâ€™uso dei cellulari	cellulari vietati|divieto|niente cellulare|no cellulare|no telefono|proibito|segnale|segno|simbolo|simbolo che vieta lâ€™uso dei cellulari|telefono|vietato telefonare
ğŸ“¶	segnale cellulare	antenna|antenna con tacche intensitÃ  segnale|cellulare|segnale|tacche|telefono
ğŸ“·	fotocamera	foto|fotocamera|fotografare|instagram|macchina fotografica|ricordi|scattare foto|selfie|viaggiare|video
ğŸ“¸	fotocamera con flash	flash|foto con flash|fotocamera|fotocamera con flash|fotografare|macchina fotografica|macchina fotografica con flash|ricordi|scattare foto|selfie
ğŸ“¹	videocamera	attore|attrice|camera|film|filmare|filmino|fotocamera|regista|registrare|telecamera|video|videocamera
ğŸ“º	televisore	arredamento|televisione|televisore|TV
ğŸ“»	radio	ascoltare|ascoltare la radio|musica|radio|stazioni radio
ğŸ“¼	videocassetta	cassetta|registrare|VHS|video|videocassetta|vintage
ğŸ“¿	collana da preghiera	grani|perle|pregare|religione
ğŸ”€	pulsante di riproduzione casuale	frecce|frecce incrociate|frecce incrociate verso destra|pulsante di riproduzione casuale|shuffle
ğŸ”	pulsante di ripetizione della riproduzione	frecce|frecce a cerchio|frecce senso orario|freccia|orario|pulsante|pulsante di ripetizione della riproduzione|senso orario|simbolo|tasto
ğŸ”‚	pulsante di ripetizione della riproduzione di una traccia	frecce|frecce a cerchio numero 1|frecce senso orario|frecce senso orario numero 1|pulsante di ripetizione della riproduzione di una traccia|ripeti|ripetizione|senso orario
ğŸ”ƒ	frecce verticali che ruotano in senso orario	ciclo|circolo|frecce|frecce a cerchio verticali|frecce verticali che ruotano in senso orario|frecce verticali senso orario|orario|processo|ricarica|ricaricare|senso orario|simbolo
ğŸ”„	frecce che ruotano in senso antiorario	antiorario|circolo|di nuovo|frecce|frecce a cerchio aperto|frecce che ruotano in senso antiorario|frecce senso antiorario|ricarica|ricaricare|simbolo
ğŸ”…	luminositÃ  bassa	bassa|faretto|faro|luce|luminositÃ |simbolo luminositÃ |sole|tenue
ğŸ”†	luminositÃ  elevata	alta luminositÃ |luminositÃ |luminositÃ  elevata|luminoso|simbolo alta luminositÃ |sole
ğŸ”‡	altoparlante disattivato	altoparlante barrato|audio|megafono barrato|musica|muto|no audio|no volume|silenzioso|speaker barrato|suono disattivato|volume|zitto
ğŸ”ˆ	altoparlante a volume basso	altoparlante a basso volume|altoparlante a volume basso|altoparlante attivato|audio|basso volume|megafono|speaker|suoneria|suono|suono attivo|volume|volume basso
ğŸ”‰	altoparlante a volume intermedio	altoparlante a volume intermedio|altoparlante volume basso|audio|basso|megafono|speaker|suono|volume basso|volume intermedio|volume medio
ğŸ”Š	altoparlante a volume alto	alto|altoparlante a volume alto|audio|megafono|musica|speaker|suono|volume
ğŸ”‹	batteria	autonomia|batteria|batteria scarica|carica|pila|ricaricare|verde
ğŸ”Œ	spina elettrica	elettrica|elettricista|elettricitÃ |presa elettrica|spina
ğŸ”	lente di ingrandimento rivolta a sinistra	cerca|cercare|investigare|lente|lente dâ€™ingrandimento|lente di ingrandimento rivolta a sinistra|lente ingrandimento|lente ingrandimento verso sinistra|verso sinistra
ğŸ”	lente di ingrandimento rivolta a destra	cercare|investigare|investigatore|lente|lente di ingrandimento rivolta a destra|lente ingrandimento|lente ingrandimento verso destra|ricerca|spia|spiare|trovare
ğŸ”	lucchetto con penna stilo	lucchetto|lucchetto con penna stilo|penna stilografica|privacy|stilo|stilografica
ğŸ”	lucchetto chiuso con chiave	chiave|chiuso a chiave|lucchetto|lucchetto chiuso|lucchetto chiuso a chave|lucchetto chiuso con chiave|segreto|sicurezza|sicuro
ğŸ”‘	chiave	casa|chiave|lucchetto|password|segreto|sicuro
ğŸ”’	lucchetto chiuso	chiuso|chiuso a chiave|lucchetto|segreto|sicurezza
ğŸ”“	lucchetto aperto	aperto|chiuso|lucchetto|segreto|sicurezza
ğŸ””	campana	campana|campanella|campanello|chiesa|musica|scuola|stonato|suono
ğŸ”•	campana sbarrata	audio|campana|campana sbarrata|divieto|muto|silenzio|suono|volume
ğŸ”–	segnalibro	etichetta|leggere|lettura|libro|segnalibro
ğŸ”—	collegamento	collegamento|due anelli|link|simbolo link
ğŸ”˜	pulsante rotondo	campanello|cerchio|geometria|opzione|pulsante|pulsante della radio|pulsante rotondo
ğŸ”™	freccia BACK	back|freccia|freccia verso sinistra|indietro|indietro con freccia verso sinistra
ğŸ”š	freccia END	end|end con freccia verso sinistra|fine|freccia|freccia a sinistra|freccia verso sinistra
ğŸ”›	freccia ON	frecce|freccia|ON|ON con freccia e punto esclamativo|punto esclamativo|simbolo
ğŸ”œ	freccia SOON	brb|freccia|freccia nera|presto|simbolo|soon|soon con freccia verso destra|tra poco|un attimo
ğŸ”	freccia TOP	alto|freccia in alto|freccia TOP|freccia verso lâ€™alto|simbolo Top|Top|Top con freccia verso lâ€™alto
ğŸ”	simbolo di divieto ai minorenni	18|18 sbarrato|divieto|divieto ai minori|minori|proibito|simbolo di divieto ai minorenni|vietato|vietato ai minori|vietato ai minori di 18|vietato ai minori di anni 18
ğŸ” 	pulsante con lettere latine maiuscole	abcd|caratteri latini|inserire|lettere|maiuscole|pulsante|pulsante con lettere latine maiuscole|tasto
ğŸ”¡	pulsante con lettere latine minuscole	caratteri latini|inserire|lettere|minuscole|pulsante|pulsante con lettere latine minuscole|tasto
ğŸ”¢	pulsante con numeri	1234|inserire|numeri|pulsante con numeri|tastierino numerico
ğŸ”£	pulsante con simboli	inserire|pulsante con simboli|simboli|tastiera|tastierino simboli
ğŸ”¤	pulsante con lettere latine	ABC|alfabeto|caratteri alfabetici|inglese|inserire|lettere|pulsante|pulsante con lettere latine|tasto
ğŸ”¥	fuoco	bruciare|caldo|calore|esplosione|falÃ²|fiamma|fiamme|fuoco|inferno|passione
ğŸ”¦	torcia	elettrica|luce|pila|torcia
ğŸ”§	chiave inglese	attrezzo|chiave|diy|fai da te|idraulico|inglese|lavoro|meccanico|utensile
ğŸ”¨	martello	attrezzo|bricolage|falegname|lavoro|martello|meccanico|muratore|operaio|riparare|riparazioni|utensile
ğŸ”©	vite e bullone	attrezzo|bricolage|bullonare|bullone|dado|fai da te|fissare|lavori di casa|lavoro
ğŸ”ª	coltello da cucina	arma|chef|coltello|coltello da cucina|cucina|fame|posate
ğŸ”«	pistola ad acqua	arma|pistola|pistola ad acqua|revolver|sparare
ğŸ”¬	microscopio	analisi|esperimento|microrganismo|microscopio|ricerca|scienza|scienziata|scienziato|strumento
ğŸ”­	telescopio	astronomia|corpi celesti|costellazioni|galileo galilei|osservatorio|osservazione delle stelle|scientifico|scienza|spazio|stelle|telescopio|universo
ğŸ”®	sfera di cristallo	chiaroveggenza|chiromanzia|cristallo|futuro|magia|sfera|sfera di cristallo|sfera viola
ğŸ”¯	stella a sei punte	chiromanzia|futuro|sei punte|stella|stella a sei punte
ğŸ”°	ideogramma giapponese di â€œPrincipianteâ€	etichetta gialla e verde principiante|gallone|giallo|ideogramma giapponese di â€œPrincipianteâ€|patente|principiante|simbolo principiante Giappone|verde|zig zag
ğŸ”±	tridente	ancora|barca|dio del mare|favola|fiaba|marino|naufragio|nave|oceano|poseidone|simbolo|tridente
ğŸ”²	tasto quadrato bianco con bordo nero	geometria|pulsante|pulsante quadrato pieno|quadrato|quadrato nero|simbolo|tasto|tasto quadrato bianco con bordo nero
ğŸ”³	tasto quadrato nero con bordo bianco	contorno|geometria|pulsante|pulsante quadrato con contorno|tasto quadrato nero con bordo bianco
ğŸ”´	cerchio rosso	cerchio|cerchio rosso grande|geometria|rosso|stop
ğŸ”µ	cerchio blu	blu|cerchio|geometria|grande
ğŸ”¶	rombo arancione grande	arancione|forma|geometria|grande|quadrato|rombo
ğŸ”·	rombo blu grande	blu|diamante|grande|rombo
ğŸ”¸	rombo arancione piccolo	arancione|piccolo|rombo
ğŸ”¹	rombo blu piccolo	blu|piccolo|rombo
ğŸ”º	triangolo rosso con punta verso lâ€™alto	alto|forma|geometria|rosso|triangolo|triangolo rosso con punta verso lâ€™alto|triangolo rosso punta in alto
ğŸ”»	triangolo rosso con punta verso il basso	basso|geometria|rosso|triangolo|triangolo rosso con punta verso il basso|triangolo rosso punta in basso
ğŸ”¼	pulsante a triangolo rivolto verso lâ€™alto	alto|in alto|pulsante|pulsante a triangolo rivolto verso lâ€™alto|tasto|triangolo
ğŸ”½	pulsante a triangolo rivolto verso il basso	basso|in basso|in giÃ¹|pulsante|pulsante a triangolo rivolto verso il basso|tasto|triangolo|triangolo con punta in basso|triangolo in basso
ğŸ•‹	Kaaba	Arabia Saudita|Islam|islamismo|Islamismo|Kaaba|La Mecca|musulmana|musulmani|musulmano|religione
ğŸ•Œ	moschea	islam|islamismo|Islamismo|moschea|musulmani|musulmano|pregare|preghiera|religione
ğŸ•	sinagoga	ebraismo|Ebraismo|religione|sinagoga|tempio ebraico
ğŸ•	Menorah	candelabro|Ebraismo|Menorah|religione|sette bracci
ğŸ•	ore una	1:00|13:00|ora|ore una|orologio|tempo
ğŸ•‘	ore due	14:00|2:00|ore due|orologio|tempo
ğŸ•’	ore tre	15:00|3:00|ora|ore tre|orologio|tempo
ğŸ•“	ore quattro	16:00|4:00|ora|ore quattro|orologio|quattro|tempo
ğŸ•”	ore cinque	17:00|5:00|ora|ore cinque|orologio|tempo
ğŸ••	ore sei	18:00|6:00|ora|ore sei|orologio|tempo
ğŸ•–	ore sette	19:00|7:00|ora|ore sette|orologio|tempo
ğŸ•—	ore otto	20:00|8:00|ore otto|orologio|otto
ğŸ•˜	ore nove	21:00|9:00|ora|ore nove|orologio|tempo
ğŸ•™	ore dieci	10:00|22:00|ora|ore dieci|orologio|tempo
ğŸ•š	ore undici	11:00|23:00|ore undici|orologio|undici
ğŸ•›	ore dodici	12:00|mezzanotte|mezzogiorno|ora|ore dodici|orologio|tempo
ğŸ•œ	ore una e mezza	1:30|13:30|ora|ore una e mezza|orologio|tempo
ğŸ•	ore due e mezza	14:30|2:30|due e mezza|ore due e mezza|orologio
ğŸ•	ore tre e mezza	15:00|3:30|ore tre e mezza|orologio|tre e mezza
ğŸ•Ÿ	ore quattro e mezza	16:30|4:30|ora|ore quattro e mezza|orologio|tempo
ğŸ• 	ore cinque e mezza	17:30|5:30|ora|ore cinque e mezza|orologio|tempo
ğŸ•¡	ore sei e mezza	18:30|6:30|ora|ore sei e mezza|orologio|tempo
ğŸ•¢	ore sette e mezza	19:30|7:30|ora|ore sette e mezza|orologio|tempo
ğŸ•£	ore otto e mezza	20:30|8:30|ora|ore otto e mezza|orologio|otto e mezza|tempo
ğŸ•¤	ore nove e mezza	21:30|9:30|nove e mezza|ora|ore nove e mezza|orologio
ğŸ•¥	ore dieci e mezza	10:30|22:30|ora|ore dieci e mezza|orologio|tempo
ğŸ•¦	ore undici e mezza	11:30|23:30|ora|ore undici e mezza|orologio|tempo
ğŸ•§	ore dodici e mezza	12:30|mezzanotte e mezza|mezzogiorno e mezza|ora|ore dodici e mezza|tempo
ğŸ•º	uomo che balla	ballare|ballo|disco|discoteca|lavoro|uomo|uomo che balla
ğŸ–•	dito medio	dita|dito|dito medio|insulto|mano|offendere|volgare
ğŸ––	saluto vulcaniano	mano|mano aperta|mano di Spock|saluto|saluto vulcaniano|Spock
ğŸ–¤	cuore nero	crudele|cuore|dolore|nero|tristezza
ğŸ—»	Monte Fuji	Fuji|Giappone|montagna|monte|natura|paesaggio
ğŸ—¼	Torre di Tokyo	architettura|cittÃ |Giappone|Tokyo|Tokyo Tower|torre|Torre di Tokyo|torre rossa
ğŸ—½	Statua della LibertÃ 	america|libertÃ |new york|simbolo|statua|Statua della LibertÃ 
ğŸ—¾	mappa del Giappone	Giappone|mappa|mappa del Giappone|Mappa del Giappone
ğŸ—¿	Moai	faccia|Isola di Pasqua|Moai|Moyai|pietra|statua|statua dellâ€™Isola di Pasqua|storia|vacanza|viaggiare
ğŸ˜€	faccina con un gran sorriso	allegria|allegro|denti|faccina con un gran sorriso|felice|molto felice|risata|sogghignare|sogghigno|sorriso
ğŸ˜	faccina raggiante con occhi felici	denti|faccina|faccina che ride|faccina che sogghigna|faccina raggiante con occhi felici|molto felice|occhi felici|risata|sogghignare|sogghigno|sogghigno con occhi felici|sorriso
ğŸ˜‚	faccina con lacrime di gioia	ahahaha|che ridere|contentissimo|contento|faccina|faccina che piange dal ridere|felice|felicissimo|felicitÃ |gioia|lacrima|lacrime di gioia|lol|piangere dal ridere|ridere|risata|rofl
ğŸ˜ƒ	faccina con sorriso e occhi spalancati	bocca aperta|che bello|contento|denti|evvai|faccina con un gran sorriso e occhi spalancati|felice|felicitÃ |ottimo|ridere|risata|sorridente|sorridere|sorriso a bocca aperta|urrÃ 
ğŸ˜„	faccina con sorriso e occhi sorridenti	a crepapelle|bene|bocca aperta|faccina che ride|faccina con un gran sorriso e occhi sorridenti|faccina felice|felicitÃ |occhi felici|ridere|risata|sorriso|sorriso a bocca aperta
ğŸ˜…	faccina con sorriso e goccia di sudore	emozionato|faccina con un gran sorriso e goccia di sudore|felice|goccia|nervoso|sollevato|sollievo|sorriso con goccia di sudore|stressato|sudore|teso
ğŸ˜†	sorriso a bocca aperta con occhi chiusi	ahahah|bocca aperta|faccina felice|faccina sorridente|felicissimo|lol|occhi chiusi|ridere|risata|sorridente|sorriso a bocca aperta con occhi chiusi
ğŸ˜‡	faccina con sorriso e aureola	angelo|angioletto|aureola|faccina sorridente con aureola|innocente|santarellino|santo|sorriso con aureola|spirito
ğŸ˜ˆ	faccina con sorriso e corna	arrabbiato|corna|diavolo|faccina|faccina con sorriso e corna|faccina viola|sorriso|sorriso con corna
ğŸ˜‰	faccina che fa lâ€™occhiolino	capirsi|faccina|faccina che fa lâ€™occhiolino|fare lâ€™occhiolino|flirtare|intesa|occhio|occhiolino|sexy|strizzare lâ€™occhio
ğŸ˜Š	faccina con occhi sorridenti	arrossire|bocca|faccina|faccina con occhi sorridenti|felice|felicitÃ |imbarazzato|occhi|occhi sorridenti|sorriso|timido
ğŸ˜‹	faccina che si lecca i baffi	buonissimo|buono|che buono|cibo delizioso|faccina che si lecca i baffi|gnam|golosa|goloso|leccarsi i baffi|slurp
ğŸ˜Œ	faccina sollevata	faccina|faccina con sorriso|pace|sollevato|sollievo|tranquillitÃ |tranquillo|zen
ğŸ˜	faccina con sorriso e occhi a cuore	amore|cuore|faccina|faccina con sorriso e occhi a cuore|innamorato|occhi|occhi a cuore|romantico|sorriso|sorriso con occhi a cuore
ğŸ˜	faccina con sorriso e occhiali da sole	cool|fighetto|figo|ganzo|luce|relax|soleggiato|spensierato|vacanza
ğŸ˜	faccina con sorrisetto	ammiccante|bocca|faccia|faccina con sorrisetto|flirtare|furbetto|malizioso|mmm|non ci credo|occhiolino|sopracciglia|sorrisetto|sospetto|sospettoso
ğŸ˜	faccina neutra	ah|imbarazzato|imbarazzo|impassibile|mmm|neutro|no comment|non fa ridere|non rido|oh|senza espressione|senza parole|uh
ğŸ˜‘	faccina inespressiva	brutto|cattivo|come no|faccina|inespressiva|male|neutro|niente commenti|no comment|strano
ğŸ˜’	faccina contrariata	che barba|contrariato|deluso|faccina|indifferente|infelice|triste|uff|uffa|ugh|wtf
ğŸ˜“	faccina abbattuta sudata	ci Ã¨ mancato poco|delusione|faccina|faccina abbattuta sudata|faccina sudata|goccia|malato|sudore|triste
ğŸ˜”	faccina pensierosa	mai una gioia|male|mi dispiace|morire|no|peccato|pensieroso|perdere|persa|purtroppo|scoraggiato|triste
ğŸ˜•	faccina confusa	confuso|deluso|faccina|forse|non so|peccato|triste|uffa
ğŸ˜–	faccina frustrata	arrabbiato|concentrato|confuso|doh|faccia|faccina|frustrato|scontento|stressato|triste|uffa
ğŸ˜—	faccina che bacia	appuntamento|bacio|bocca|buona notte|faccina che manda bacio|flirt|sbaciucchiare
ğŸ˜˜	faccina che manda un bacio	amore|bacetti|bacini|buona notte|cuore|faccina che manda baci|innamorato|mandare baci|mi manchi|smack|ti amo|ti voglio bene
ğŸ˜™	faccina che bacia con occhi sorridenti	appuntamento|bacetti|buona notte|faccina che manda baci|occhi chiusi|occhi sorridenti|sorriso
ğŸ˜š	faccina che bacia con occhi chiusi	amore|bacetti|bacio a occhi chiusi|buona notte|faccina|faccina che bacia con occhi chiusi|occhi chiusi|ti amo|ti voglio bene|tvb
ğŸ˜›	faccina che mostra la lingua	bello|faccina|faccina che fa la linguaccia|faccina che mostra la lingua|faccina con lingua fuori|fantastico|lingua|lingua fuori|linguaccia
ğŸ˜œ	faccina che fa lâ€™occhiolino e mostra la lingua	barzelletta|divertente|faccina che fa lâ€™occhiolino e mostra la lingua|lingua fuori con occhiolino|linguaccia con occhiolino|occhiolino|pazzerello|pazzo|scherzo|sto scherzando|strano|yolo
ğŸ˜	faccina che strizza gli occhi e mostra la lingua	bleah|faccina|faccina che strizza gli occhi e mostra la lingua|faccina con un gran sorriso che mostra la lingua|lingua|linguaccia|linguaccia con occhi chiusi|non mi piace|occhi chiusi|orribile|terribile
ğŸ˜	faccina delusa	abbandonare|delusione|disilluso|emozione|faccina|fallimento|fallire|fallito|ho perso|infelice|male|no|perdere|sospiro|triste|uffa
ğŸ˜Ÿ	faccina preoccupata	ansioso|faccina|nodo allo stomaco|preoccupato|preoccupazione|triste
ğŸ˜ 	faccina arrabbiata	arrabbiato|che odio|faccina|frustrato|furia|infuriato|non mi piace|odio|rabbia
ğŸ˜¡	faccina accigliata	arrabbiato|broncio|faccina|faccina accigliata|faccina rossa|furioso|imbronciato|male|muso|odio
ğŸ˜¢	faccina che piange	emozione|faccina|faccina che piange|faccina con lacrima|infelice|lacrima|mi dispiace|mi manchi|piangere|triste
ğŸ˜£	faccina perseverante	concentrato|faccina|faccina che pensa|faccina concentrata|pensare|perseverante
ğŸ˜¤	faccina che sbuffa	arrabbiarsi|arrabbiato|faccina arrabbiata|faccina che sbuffa|faccina con il fumo|faccina frustrata|frustrato|frustrazione|rabbia|sbuffare|scontento|uffa
ğŸ˜¥	faccina delusa ma sollevata	ansioso|deluso|deluso ma sollevato|faccina|faccina delusa ma sollevata|goccia|infelice|lacrima|sollevato|sudore|triste
ğŸ˜¦	faccina imbronciata con bocca aperta	bocca aperta|corrucciata|faccina imbronciata con bocca aperta|male|no|noo|paura|sorpresa|wow
ğŸ˜§	faccina angosciata	angoscia|angosciato|ansia|ansioso|faccina|infelice|paura|sofferente|stressato|triste
ğŸ˜¨	faccina impaurita	ansia|ansioso|esami|faccina|fifa|fifa blu|impaurito|paura|preoccupato|spaventato|spavento
ğŸ˜©	faccina esausta	arrabbiato|disperato|esausto|faccina|faccina che piange|nooo|piangere|sfinito|stanco
ğŸ˜ª	faccina assonnata	assonnato|dormire|faccina|faccina assonnata|goccia|sonno|stanco|zzz
ğŸ˜«	faccina stanca	disperato|faccina|stanco|triste
ğŸ˜¬	faccina con smorfia	denti|dentista|digrignare|digrignare i denti|faccina|faccina con smorfia|smorfia
ğŸ˜­	faccina disperata	faccina che piange|faccina disperata|infelice|lacrime|no|nooo|piangere|pianto|singhiozzare|triste
ğŸ˜®	faccina con bocca aperta	bocca|bocca aperta|non ci credo|non mi dire|oh|scioccato|shock|sorpresa|sorpreso|stupito|wow
ğŸ˜®â€ğŸ’¨	faccina che espira	ansimare|esausto|espirare|faccina che espira|fischiare|fumo|soffio|sollievo|sospiro|stanco|sussurrare|tosse
ğŸ˜¯	faccina sorpresa	faccina|incredulo|omg|sbalordito|sorpresa|sorpreso|wow
ğŸ˜°	faccina sudata in ansia	ansia|blu|esami|faccina spaventata|freddo|nervoso|paura|risultato|spaventato|sudato|sudore|terrore
ğŸ˜±	faccina terrorizzata	blu|faccina|grido di paura|munch|oddio|paura|terrore|terrorizzata|urlare|urlo di munch
ğŸ˜²	faccina stupita	cosa?|davvero|faccina|non ci credo|oddio|omg|scioccato|sorpresa|sorpreso|stupito
ğŸ˜³	faccina imbarazzata	confuso|faccina|faccina arrossata|faccina con guance rosse|faccina con occhi aperti|guance rosse|imbarazzato|occhi
ğŸ˜´	faccina che dorme	assonnato|buona notte|dormire|faccina|faccina che dorme|pisolino|sonno|stanco|zzz
ğŸ˜µ	faccina frastornata	crocetta|crocette|emozione|faccina|frastornato|malato|occhi|occhi a croce|stanco|testa che gira
ğŸ˜µâ€ğŸ’«	faccina con occhi a spirale	capogiro|confuso|faccina|faccina con occhi a spirale|giramento di testa|ipnotizzato|nausea|problema|stordito|vertigini
ğŸ˜¶	faccina senza bocca	faccina|faccina senza bocca|muto|non parlo|non posso parlare|segreto|senza bocca|senza espressione|senza parole|silenzio|zitto
ğŸ˜·	faccina con mascherina	dentista|dottore|faccina con mascherina|germi|infermiera|infermiere|malato|mascherina|medicina|raffreddato|raffreddore|smog
ğŸ˜¸	gatto che sogghigna	faccina|gatto|occhi|sorridente|sorriso
ğŸ˜¹	gatto con lacrime di gioia	faccina|gatto|gioia|lacrime di gioia|risata|sorriso
ğŸ˜º	gatto che sorride	aperta|bocca|faccina|faccina del gatto|gatto|gatto che sorride|sorridente
ğŸ˜»	gatto innamorato	amore|cuore|faccina|gatto|occhi a cuore|sorriso
ğŸ˜¼	gatto con sorriso sarcastico	faccina|faccina del gatto|gatto|gatto con sorriso sarcastico|gatto sorriso ironico|gatto sorriso sarcastico|ironico|sarcastico|sorriso ironico
ğŸ˜½	gatto che manda baci	baci|faccina|gatto|occhi chiusi
ğŸ˜¾	gatto imbronciato	arrabbiato|broncio|faccina|gatto|gatto imbronciato|infelice|muso
ğŸ˜¿	gatto che piange	faccina|gatto|lacrima|pianto|triste
ğŸ™€	gatto esterrefatto	esterrefatto|faccina|gatto|impossibile|incredibile|non ci credo|oh mio Dio|OMG|sorpreso|wow
ğŸ™	faccina leggermente imbronciata	corrucciato|faccina|faccina leggermente imbronciata|imbronciato|mettere il muso|mi dispiace|triste|un poâ€™ imbronciato
ğŸ™‚	faccina con sorriso accennato	contento|faccina|faccina che sorride|faccina con sorriso accennato|felice|mezzo sorriso|ok|sorrisetto|sorriso|sorriso a bocca chiusa|sorriso accennato|va bene
ğŸ™ƒ	faccina sottosopra	ah ah|ah ah ah|ahah|ahahah|arrabbiato|capovolto|faccina|sarcastico|scombussolata|sottosopra|triste
ğŸ™„	faccina con occhi al cielo	evabbÃ©|faccina con occhi al cielo|guardare altrove|noia|occhi al cielo|pazienza|roteare gli occhi|ruotare gli occhi|sollevare gli occhi al cielo|uffa|vabbÃ¨
ğŸ™…	persona che fa segno di no	donna|escluso|faccina|gesto|gesto di rifiuto|no|non bene|persona|persona che fa segno di no|rifiuto|stop|vietato
ğŸ™†	persona con gesto OK	donna|donna con braccia alzate|esercizio|fitness|gesto|mani|OK|persona|persona con gesto OK|tutto bene|yoga
ğŸ™‡	persona che fa un inchino profondo	chiedere perdono|gesto|grazie|inchino|meditare|mi dispiace|perdono|persona|persona che fa un inchino profondo|pietÃ |scusarsi
ğŸ™ˆ	non vedo	faccina|faccina della scimmietta|gesto|non guardo|non posso guardare|non vedo|proibito|scimmia|scimmietta|scimmietta non vedo|segreto|vietato
ğŸ™‰	non sento	animale|animali|faccina|non sentire|non sento|orecchie da mercante|scimmia|scimmietta|scimmietta non sento|segreto|vietato
ğŸ™Š	non parlo	animale|animali|faccina|in silenzio|monello|non parlo|proibito|scimmia|scimmietta non parlo|segreto|vietato
ğŸ™‹	persona con mano alzata	ciao|donna|eccomi|felice|gesto|mano alzata|persona|persona con mano alzata|salutare|saluto|sono qui
ğŸ™Œ	mani alzate	celebrare|due mani|evvai|evviva|gesto|grazie|innocente|mani alzate|mano|urrÃ |vittoria
ğŸ™	persona corrucciata	arrabbiata|corrucciata|delusa|donna|faccia|frustrata|gesto|infelice|persona|triste
ğŸ™	persona imbronciata	arrabbiata|broncio|delusa|donna|gesto|imbronciata|persona|seccata|sguardo arrabbiato
ğŸ™	mani giunte	gesto|grazie|mani|mani giunte|mano|per favore|pregare|preghiera|ti prego
ğŸš€	razzo	astronauta|astronave|razzo|spazio|trasporti|universo|veicolo|viaggiare|viaggio
ğŸš	elicottero	elicottero|trasporti|veicolo|velivolo|viaggiare|volare
ğŸš‚	locomotiva	ferrovia|locomotiva|locomotiva a vapore|motore|treno|vapore|veicolo|viaggiare
ğŸšƒ	vagone	elettrico|ferrovia|tram|trasporto|treno|vagone|veicolo|viaggiare
ğŸš„	treno alta velocitÃ 	alta velocitÃ |ferrovia|freccia|tav|trasporto|treno|treno alta velocitÃ |veicolo|veloce|viaggiare
ğŸš…	treno alta velocitÃ  punta arrotondata	alta velocitÃ |ferrovia|mezzo|punta arrotondata|trasporti|trasporto|treno|treno alta velocitÃ |treno alta velocitÃ  punta arrotondata|veicolo|veloce|viaggiare
ğŸš†	treno	arrivo|binari|ferrovia|freccia|mezzo|trasporto|treno|veloce
ğŸš‡	metropolitana	metro|metropolitana|mezzo|trasporti|trasporto|veicolo|viaggiare
ğŸšˆ	metrotranvia	arrivare|ferrovia|metrotranvia|mezzo|monorotaia|tram|trasporti|trasporto|treno|veicolo|viaggiare
ğŸš‰	stazione	arrivo|fermata|ferrovia|ritardo|stazione|trasporto|treno|veicolo|viaggiare
ğŸšŠ	tram	arrivo|ferrovia|freccia|partire|pendolare|tram|trasporto|treno|veicolo|veloce|velocitÃ |viaggiare
ğŸš‹	vagone del tram	filobus|mezzo|tram|trasporti|trasporto|vagone|vagone del tram|veicolo
ğŸšŒ	bus	autobus|bus|mezzo|scuola|scuolabus|trasporti|trasporto|veicolo
ğŸš	bus in arrivo	autobus|bus|bus in arrivo|in arrivo|mezzo|scuolabus|trasporti|trasporto|veicolo|viaggiare
ğŸš	filobus	autobus|bus|cittÃ |filobus|mezzo|tram|trasporti pubblici|veicolo|viaggiare
ğŸš	fermata dellâ€™autobus	autobus|fermata|fermata dellâ€™autobus|pendolare|stop|viaggiare
ğŸš	pulmino	bus|fiorino|guidare|minibus|pullmino|pulmino|veicolo|viaggiare
ğŸš‘	ambulanza	ambulanza|croce rossa|emergenza|incidente|mezzo|ospedale|trasporto|veicolo
ğŸš’	camion dei pompieri	autopompa|camion dei pompieri|emergenza|incendio|mezzo|pompieri|veicolo|vigili del fuoco
ğŸš“	macchina della polizia	auto|carabinieri|gazzella|macchina|macchina della polizia|polizia|veicolo
ğŸš”	macchina della polizia in arrivo	auto della polizia|automobile|gazzella|macchina della polizia|mezzo|polizia|trasporti|trasporto|veicolo|volante
ğŸš•	taxi	auto|guidare|mezzo|tassÃ¬|taxi|taxi giallo|trasporto|veicolo
ğŸš–	taxi in arrivo	mezzo|tassÃ¬|taxi|taxi giallo|taxi in arrivo|trasporti|trasporto|veicolo
ğŸš—	auto	auto|automobile|guidare|macchina|mezzo|trasporti|veicolo|viaggiare
ğŸš˜	auto in arrivo	auto|auto in arrivo|automobile|automobile in arrivo|guidare|in arrivo|mezzo|trasporti|trasporto|veicolo
ğŸš™	SUV	auto|automobile|guidare|macchina|SUV|trasporti|utilitaria|veicolo|viaggiare
ğŸšš	camion	camion|consegna|in viaggio|mezzo|trasporti|trasporto|veicolo
ğŸš›	autoarticolato	autoarticolato|camion|guidare|rimorchio|spedizione|trasporto|veicolo|viaggiare
ğŸšœ	trattore	agricolo|campagna|fattoria|guidare|lavoro|mezzo|trattore|veicolo
ğŸš	monorotaia	mezzo|monorotaia|trasporti|trasporto|veicolo|veloce|viaggiare
ğŸš	ferrovia di montagna	ferrovia|ferrovia di montagna|montagna|trasporti|treno|treno di montagna|veicolo|viaggiare
ğŸšŸ	ferrovia sospesa	ferrovia sospesa|funivia|mezzo|trasporti|trasporto|veicolo
ğŸš 	funivia	cabina|funicolare|funivia|montagna|sci|ski lift|trasporti|trasporto|veicolo
ğŸš¡	funivia aerea	aerea|funicolare|funivia|montagna|sci|sciare|tram|trasporto
ğŸš¢	nave	barca|crociera|imbarcazione|mare|nave|titanic|trasporti|trasporto|veicolo|viaggiare
ğŸš£	persona in barca a remi	barca|barca a remi|canoa|fiume|lago|persona|persona che rema|persona in barca a remi|pesca|remare|remi|sport
ğŸš¤	motoscafo	barca|lago|lusso|mare|mezzo|milionario|motoscafo|vacanza|vacanze|veicolo|veloce
ğŸš¥	semaforo orizzontale	orizzontale|semaforo|traffico
ğŸš¦	semaforo verticale	incrocio|luce|segnale|semaforo|stop|traffico|verticale
ğŸš§	area cantiere	area cantiere|costruzione|giallo e nero|simbolo|simbolo area cantiere
ğŸš¨	lampeggiante	carabinieri|emergenza|lampeggiante|luce|rosso|sirena|sirena dei carabinieri|sirena della polizia
ğŸš©	bandierina rossa	bandiera|bandiera rossa|bandiera rossa triangolare|bandierina|bandierina rossa|bandierina rossa triangolare|golf
ğŸšª	porta	aprire|armadio|chiudere|entrare|porta|portoncino|uscire
ğŸš«	segnale di divieto	divieto|proibito|segnale di divieto|simbolo|simbolo di divieto|vietato|vietato fumare|vietato lâ€™accesso
ğŸš¬	sigaretta	area fumatori|fumare|fumo|sigaretta|simbolo
ğŸš­	segnale di vietato fumare	divieto|fumare|fumo|proibito|segnale|segnale di vietato fumare|sigarette|simbolo|vietato
ğŸš®	simbolo per la raccolta dei rifiuti	buttare|cestino dei rifiuti|pattumiera|raccolta rifiuti|riciclare|rifiuti|simbolo|simbolo per la raccolta dei rifiuti|simbolo raccolta rifiuti
ğŸš¯	simbolo del divieto di gettare rifiuti	buttare|divieto|proibito|simbolo|simbolo del divieto di gettare rifiuti|simbolo vietato gettare rifiuti|vietato gettare rifiuti
ğŸš°	acqua potabile	acqua|bere|goccia|potabile|rubinetto|simbolo
ğŸš±	simbolo di acqua non potabile	acqua|acqua non potabile|divieto|non potabile|rubinetto|simbolo|simbolo acqua non potabile|simbolo di acqua non potabile|vietato
ğŸš²	bicicletta	bici|bicicletta|due ruote|gita|mezzo|pedalare|spinning|sport|trasporti|trasporto|veicolo
ğŸš³	segnale di divieto di transito delle biciclette	bici|bicicletta|divieto bicicletta|divieto biciclette|divieto di transito|divieto transito biciclette|proibito|segnale|segnale di divieto di transito delle biciclette
ğŸš´	ciclista	bici|bicicletta|ciclismo|ciclista|due ruote|gara|mountain bike|pedalare|sport|trasporto
ğŸšµ	ciclista di mountain bike	atleta|bicicletta|ciclismo|ciclismo in montagna|ciclista|ciclista di mountain bike|montagna|mountain bike|pedalare|sport
ğŸš¶	pedone	attivitÃ |camminare|camminata|giro a piedi|passeggiare|passeggiare lentamente|passeggiata|passo tranquillo|pedone|persona
ğŸš·	simbolo del divieto di transito pedoni	divieto transito pedoni|niente pedoni|no|no pedoni|proibito|segnale|simbolo|simbolo del divieto di transito pedoni|strada|vietato
ğŸš¸	attraversamento bambini	attraversamento|attraversamento pedonale|attraversare|bambini|pedoni|scuola|segnale|simbolo|strada|traffico
ğŸš¹	simbolo del bagno degli uomini	bagno|segnale|simbolo|simbolo del bagno degli uomini|toilette|Uomini|uomo
ğŸšº	simbolo del bagno delle donne	bagno donne|Donne|segnale|servizi|simbolo|simbolo bagno donne|simbolo del bagno delle donne|toilette
ğŸš»	simbolo dei servizi igienici	bagni|bagno|cartello|figure|omini|pulsante|servizi|simbolo|simbolo dei servizi igienici|tasto|toilette|wc
ğŸš¼	simbolo con immagine di bambino	bambino a bordo|cartello neonato|fasciatoio|neonato|simbolo con immagine di bambino|simbolo neonato
ğŸš½	toilette	bagno|toilette|trono|water
ğŸš¾	simbolo del WC	bagni|bagno|gabinetto|segnale|servizi|simbolo del WC|toilette|WC
ğŸš¿	doccia	aqua|doccia|fare la doccia|lavare|lavarsi
ğŸ›€	persona che fa il bagno	bagno|doccia|fare il bagno|lavarsi|persona che fa il bagno|relax|vasca da bagno
ğŸ›	vasca	bagno|doccia|lavare|lavarsi|relax|vasca|vasca da bagno
ğŸ›‚	simbolo del controllo passaporti	aeroporto|controllo|dogana|immigrazione|passaporti|passaporto|segnale|simbolo del controllo passaporti
ğŸ›ƒ	simbolo della dogana	confine di Stato|controllo doganale|dogana|doganiere|frontiera|polizia|polizia di frontiera|simbolo della dogana|viaggiare
ğŸ›„	simbolo del ritiro bagagli	aereo|aeroporto|arrivare|bagagli|check in|gita|partire|pronti|ritiro|simbolo del ritiro bagagli|valigie|viaggio
ğŸ›…	simbolo del deposito bagagli	aeroporto|bagagli|deposito|servizio bagagli|sicurezza|simbolo del deposito bagagli|viaggiare
ğŸ›Œ	persona a letto	addormentato|arredamento|dormire|hotel|letto|notte|persona a letto|sonno|stanca|stanco|zzz
ğŸ›	luogo di culto	luogo di culto|luogo di preghiera|luogo sacro|persona che prega|pregare|preghiera|religione|silenzio|simbolo
ğŸ›‘	segnale di stop	geometria|ottagonale|ottagono|rosso|segnale|segnale di stop|stop
ğŸ›’	carrello	acquistare|acquisti|acquisto|carrello|carrello della spesa|centro commerciale|fare la spesa|shopping|spesa|supermercato
ğŸ›•	tempio indÃ¹	induismo|tempio indÃ¹|tempio induista
ğŸ›–	capanna	capanna|capanno|casa|iurta|rifugio
ğŸ›—	ascensore	accessibilitÃ |ascensore|montacarichi
ğŸ›œ	wireless	computer|connessione|internet|rete|trasmissione|wi-fi|wifi|wireless
ğŸ›	scivolo	area divertimento|area giochi|giocare|giochi per bambini|parco giochi|scivolata|scivolo
ğŸ›	ruota	auto|cerchio|cerchione|girare|gomma|pneumatico|ruota|veicolo
ğŸ›Ÿ	salvagente	ciambella|galleggiante|gonfiabile|nuotare|salvagente|salvare|salvataggio|sicurezza|soccorso
ğŸ›«	decollo	aereo|andare|check-in|decollo|partenza|partenze|partire|pista di decollo|trasporti|trasporto|vacanza|viaggiare
ğŸ›¬	atterraggio	aereo|aeroplano|aeroporto|arrivare|arrivi|arrivo|atterraggio|pista dâ€™atterraggio|trasporti|trasporto|veicolo|viaggiare
ğŸ›´	monopattino	monopattino|trasporti|veicolo
ğŸ›µ	scooter	due ruote|estate|guidare|mezzo|motorino|scooter|trasporti|trasporto|vacanze romane|veicolo|vespa|viaggiare
ğŸ›¶	canoa	barca|canoa|fiume|imbarcazione|kayak|lago|mare|pagaia|sport|trasporto
ğŸ›·	slitta	inverno|montagna|neve|slitta|slittino|toboggan
ğŸ›¸	disco volante	alieni|disco volante|extra terrestri|marziani|spazio|ufo|UFO
ğŸ›¹	skateboard	andare in skate|andare sullo skateboard|rotelle|skate|skateboard|skateboarder|skater|tavola da skateboard
ğŸ›º	risciÃ² a motore	risciÃ² a motore|tuk tuk
ğŸ›»	pickup	auto|camioncino|furgoncino|pick-up|pickup|trasporto|veicolo
ğŸ›¼	pattini a rotelle	pattinaggio|pattinare|pattini|pattini a rotelle|rotelle|sport
ğŸŸ 	cerchio arancione	arancione|cerchio|cerchio arancio|cerchio di colore arancione|forma
ğŸŸ¡	cerchio giallo	cerchio|cerchio di colore giallo|colore giallo|forma|giallo
ğŸŸ¢	cerchio verde	cerchio|cerchio di colore verde|colore verde|forma|verde
ğŸŸ£	cerchio viola	cerchio|cerchio di colore viola|colore viola|forma|viola
ğŸŸ¤	cerchio marrone	cerchio|cerchio di colore marrone|colore marrone|forma|marrone
ğŸŸ¥	quadrato rosso	colore rosso|forma|quadrato|quadrato di colore rosso|rosso
ğŸŸ¦	quadrato blu	blu|colore blu|forma|quadrato|quadrato di colore blu
ğŸŸ§	quadrato arancione	arancione|colore arancione|forma|quadrato|quadrato di colore arancione
ğŸŸ¨	quadrato giallo	colore giallo|forma|giallo|quadrato|quadrato di colore giallo
ğŸŸ©	quadrato verde	colore verde|forma|quadrato|quadrato di colore verde|verde
ğŸŸª	quadrato viola	colore viola|forma|quadrato|quadrato di colore viola|viola
ğŸŸ«	quadrato marrone	colore marrone|forma|marrone|quadrato|quadrato di colore marrone
ğŸŸ°	segno di uguaglianza	matematica|segno di uguaglianza|segno uguale|uguaglianza|uguale
ğŸ¤Œ	mano a pigna	che vuoi|cosa vuoi|dita unite|gesto della mano|interrogativo|ma che dici|mano a borsa|mano a carciofo|mano a cuoppo|mano a pigna|mano a tulipano|sarcastico
ğŸ¤	cuore bianco	bianco|cuore|emozione
ğŸ¤	cuore marrone	amore|cuore|cuore di colore marrone|emozione|forma|marrone
ğŸ¤	mano che fa il gesto del pizzico	dita|gesto|mano che fa il gesto del pizzico|piccola quantitÃ |piccolo|poco|un poâ€™|un pochino
ğŸ¤	faccina con bocca con cerniera	acqua in bocca|bocca a zip|bocca cucita|faccina con bocca con cerniera|faccina con zip|no comment|non parlare|non posso parlare|segreto|silenzio|zitto
ğŸ¤‘	faccina avida di denaro	avarizia|aviditÃ |avido|denaro|dollari|faccina con lingua verde|guadagnare|lingua|pagare|ricchezza|ricco|taccagno
ğŸ¤’	faccina con termometro	ammalato|faccina|faccina con termometro|faccina malata|febbre|influenza|malato|mutua|raffreddore|termometro
ğŸ¤“	faccina nerd	faccina|nerd|occhiali|occhiali da nerd|secchione|studioso
ğŸ¤”	faccina concentrata	arrovellarsi|concentrarsi|dubbio|faccina|faccina che pensa|faccina concentrata|mmm|pensare|scervellarsi
ğŸ¤•	faccina con la testa bendata	bende|dolore|faccina|faccina bendata|faccina con la testa bendata|faccina malata|farsi male|fasciarsi la testa|ferita|ferito|mal di testa|malato
ğŸ¤–	faccina di robot	faccina|faccina di robot|robot|tecnologia
ğŸ¤—	faccina che abbraccia	abbracciare|abbraccio|ciao|faccina|faccina che abbraccia|imbarazzo|mani|mano|saluti|sorriso|ti voglio bene|tvb
ğŸ¤˜	segno delle corna	concerto|corna|fare le corna|gesto|mani|mano con le corna|rock and roll|rockstar|segno delle corna
ğŸ¤™	mano con gesto di chiamata	chiamami|chiamare|dita|dito|gesto|mani|mano|mano con gesto di chiamata|telefonare|ti chiamo
ğŸ¤š	dorso mano alzata	alzata|ciao|ciaone|dorso mano alzata|mano
ğŸ¤›	pugno a sinistra	mano|mano chiusa|pugno|pugno a sinistra|sinistra
ğŸ¤œ	pugno a destra	destra|pugno|pugno a destra
ğŸ¤	stretta di mano	affare fatto|conoscere|dâ€™accordo|mani che si stringono|ok|patto|piacere|presentarsi|presentazione|promessa|stretta di mano|stringersi la mano
ğŸ¤	dita incrociate	buona fortuna|dita|dita incrociate|fortuna|incrociare|incrociare le dita|mano
ğŸ¤Ÿ	gesto ti amo	corna|dita|dito|gesto|gesto ti amo|gesto tvb|mano|rock|tre dita
ğŸ¤ 	faccina con cappello da cowboy	cappello|cappello da cowboy|cowboy|faccina|faccina con cappello da cowboy
ğŸ¤¡	faccina pagliaccio	carnevale|circo|clown|faccina|faccina del clown|It|maschera|pagliaccio|teatro
ğŸ¤¢	faccina nauseata	faccina|faccina che vomita|faccina con la nausea|faccina nauseata|hang over|mal di mare|malato|nausea|nauseato|sto male|verde|vomito
ğŸ¤£	ridere a crepapelle	ahah|crepapelle|divertente|esilarante|faccia che si rotola|faccina che ride|felice|felicissimo|lacrime dal ridere|lmao|lol|molto felice|occhi chiusi|ridere a crepapelle|ridicolo|risata|rofl
ğŸ¤¤	faccina che sbava	bava|che buono|faccina|faccina che sbava|felice|figata|sbavare
ğŸ¤¥	faccina bugiarda	bugia|bugiardo|dire le bugie|faccina|faccina bugiarda|faccina con il naso lungo|mentire|naso lungo|pinocchio
ğŸ¤¦	persona esasperata	disperazione|esasperazione|facepalm|incredulitÃ |mano in fronte|oddio|oh no|persona|persona esasperata
ğŸ¤§	faccina che starnutisce	faccina|faccina che starnutisce|faccina con fazzoletto|faccina con raffreddore|fazzoletto|malato|raffreddore|starnutire|starnuto
ğŸ¤¨	faccina con sopracciglia alzate	diffidente|disappunto|eh|faccia con sopracciglia alzate|faccina con sopracciglio alzato|incredulo|mah|non ci credo|scetticismo|scettico|sconcertato|sorpresa|sorpreso
ğŸ¤©	colpo di fulmine	emozionante|emozionato|faccia sorridente|faccina con le stelle|felice|figata|figo|occhi a stella|stelline|wow
ğŸ¤ª	faccina impazzita	faccina|faccina con occhi pazzi|faccina impazzita|faccina pazza|grande|inquietante|occhi|occhi diversi|occhio|pazzo|piccolo|sclerato
ğŸ¤«	faccina che zittisce	dito|faccina che zittisce|muto|non parlare|segreto|silenzio|silenzioso|zittire|zitto
ğŸ¤¬	faccina con simboli sulla bocca	arrabbiato|bestemmiare|censura|faccina|faccina che bestemmia|faccina che impreca|faccina con simboli sulla bocca|imprecare|incavolato|insultare|molto arrabbiato
ğŸ¤­	faccina con mano sulla bocca	faccina che sogghigna|imbarazzato|imbarazzo|mano davanti alla bocca|non ci credo|oddio|oops|ridacchiare|ridere|segreto|sogghignare|sorpresa
ğŸ¤®	faccina che vomita	faccina|faccina che vomita|malato|male|nausea|sputare|sto male|verde|vomitare|vomito
ğŸ¤¯	testa che esplode	cervello|faccina sorpresa|mindblown|non ci credo|sbalordito|scioccato|sconcertato|sorpesa|sorpreso|stupore|testa che esplode
ğŸ¤°	donna incinta	donna|gravidanza|incinta|mamma|pancione
ğŸ¤±	allattare	allattamento|allattare|allattare al seno|bebÃ©|donna|donna che allatta|mamma|mamma che allatta|persona
ğŸ¤²	mani unite in alto	desiderare|mani|mani a coppa|mani in preghiera|mani unite|mani unite in alto|mano|offrire|palmi|palmo della mano|pregare|preghiera
ğŸ¤³	selfie	autoscatto|fare un selfie|foto|fotocamera|fotografare|fotografia|scattare|selfie|smartphone|telefono
ğŸ¤´	principe	comandare|corona|fiaba|monarca|principe|re|reale|sovrano|uomo
ğŸ¤µ	persona in smoking	abito|elegante|festa|matrimonio|persona in smoking|smoking
ğŸ¤¶	Mamma Natale	cappello|donna|fest|mamma natale|Mamma Natale|natale|santa claus
ğŸ¤·	persona che scrolla le spalle	boh|dubbio|forse|indifferenza|non lo so|non saprei|noncuranza|persona che alza le spalle|persona che scrolla le spalle|puÃ² darsi|spalle alzate|vabbÃ¨
ğŸ¤¸	persona che fa la ruota	atleta|attiva|capriola|felice|ginnasta|ginnastica|persona|persona che fa la ruota|ruota
ğŸ¤¹	persona che fa giocoleria	abilitÃ |destrezza|equilibrio|giocoliere|palline|persona|persona che fa giocoleria
ğŸ¤º	schermidore	fioretto|persona|scherma|schermidore|spada|sport
ğŸ¤¼	persone che fanno la lotta	combattimento|lottatori|persone|persone che fanno la lotta|sport|torneo|wrestler|wrestling
ğŸ¤½	persona che gioca a pallanuoto	acqua|giocatrice di pallanuoto|pallanuoto|persona|persona che gioca a pallanuoto|piscina|sport
ğŸ¤¾	persona che gioca a pallamano	atleta|lanciare|palla|pallamanista|pallamano|persona|persona che gioca a pallamano|sport|tirare la palla
ğŸ¤¿	maschera da sub	diving|fare immersioni|immersioni|maschera da sub|maschera e boccaglio|nuotare|nuoto|snorkeling|sport
ğŸ¥€	fiore appassito	appassito|fiore|natura|pianta|rosa|rosa appassita|sfiorire|sfiorita
ğŸ¥	tamburo	bacchette|banda|musica|percussioni|tamburello|tamburo
ğŸ¥‚	brindisi	anniversario|auguri|bere|brindare|brindisi|champagne|cin cin|compleanno|congratulazioni|festeggiare|prosecco|spumante
ğŸ¥ƒ	bicchiere tumbler	alcool|bevanda|bicchiere|drink|liquore|tumbler|whisky
ğŸ¥„	cucchiaio	cucchiaino|cucchiaio|cucina|posate|stoviglie|utensili
ğŸ¥…	porta da calcio	calcio|gol|porta|porta da calcio|porta di calcio|rete|sport|traversa
ğŸ¥‡	medaglia dâ€™oro	medaglia|medaglia dâ€™oro|numero 1|numero uno|oro|primo posto|sport|uno|vincere
ğŸ¥ˆ	medaglia dâ€™argento	argento|medaglia|medaglia dâ€™argento|secondo posto|sport
ğŸ¥‰	medaglia di bronzo	bronzo|gara|medaglia|medaglia 3|medaglia di bronzo|sport|terzo|terzo posto
ğŸ¥Š	guantone da pugilato	boxe|forza|guanto|guantone|guantone da pugilato|pugilato|pugile|pugno|sport
ğŸ¥‹	kimono per arti marziali	arti marziali|judo|karate|kimono|kimono per arti marziali|sport|taekwondo|uniforme
ğŸ¥Œ	stone da curling	curling|sport|stone da curling
ğŸ¥	lacrosse	goal|lacrosse|palla|pallina|racchetta da lacrosse|rete|sport
ğŸ¥	palla da softball	guantone|palla|palla da softball|softball|sport
ğŸ¥	frisbee	disco|disco volante|frisbee|ultimate frisbee
ğŸ¥	croissant	bar|cibo|colazione|cornetto|croissant|dolce|francese|zucchero
ğŸ¥‘	avocado	avocado|cibo|frutta|frutto
ğŸ¥’	cetriolo	cetriolino sottaceto|cetriolo|cibo|ortaggio|sottâ€™aceto|sotto aceto|verdura
ğŸ¥“	pancetta	americana|bacon|carne|cibo|cibo americano|colazione|maiale|pancetta
ğŸ¥”	patata	cibo|ortaggio|patata|patatine|tubero|verdura
ğŸ¥•	carota	arancione|carota|carotene|cibo|coniglio|dieta|ortaggio|radice|sano|verdura|verdure
ğŸ¥–	baguette	baguette|carboidrati|cibo|filone|francese|Francia|pane
ğŸ¥—	insalata verde	cena|cibo|insalata|insalata mista|insalata verde|mangiare|pranzo|salutare|salute|verdure
ğŸ¥˜	padella con cibo	casseruola|cibo|cucina|cucinare|padella|padella con cibo|paella|Spagna
ğŸ¥™	pita farcita	carne|cibo|cibo turco|cucina turca|falafel|gyro|kebab|pita farcita|ripieno|ristorante
ğŸ¥š	uovo	cibo|uova|uovo
ğŸ¥›	bicchiere di latte	bevanda|bicchiere|bicchiere di latte|latte
ğŸ¥œ	arachidi	arachide|arachidi|cibo|frutta secca|nocciolina|noccioline
ğŸ¥	kiwi	cibo|frutt|frutta|frutto|kiwi
ğŸ¥	pancake	america|brunch|burro|cibo|colazione|crÃªpe|dolce|francia|frittelle|pancake|sciroppo dâ€™acero|zucchero
ğŸ¥Ÿ	raviolo	cibo|dumpling|empanada|fagottino|gyoza|jiaozi|pierogi|ravioli|raviolo
ğŸ¥ 	biscotto della fortuna	biscotto|biscotto della fortuna|cibo|cinese|consiglio|profezia|suggerimento
ğŸ¥¡	confezione da asporto	asporto|bacchette|bastoncini|cibo|cibo a domicilio|cibo cinese|cibo da asporto|confezione da asporto|consegna|scatola dâ€™asporto
ğŸ¥¢	bacchette	bacchette|bastoncini|cibo asiatico|hashi|jeotgarak|kuaizi
ğŸ¥£	ciotola con cucchiaio	cereali|cibo|ciotola|ciotola con cucchiaio|colazione|porridge|scodella|tazza|zuppa|zuppiera
ğŸ¥¤	bicchiere con cannuccia	acqua|bevanda|bevande|bibita|bibita gasata|bicchiere|bicchiere con cannuccia|cannuccia|succo
ğŸ¥¥	cocco	cibo|cocco|frutta|frutto|noce di cocco|palma|piÃ±a colada
ğŸ¥¦	broccoli	broccoli|broccolo|cavolo nero|cibo|verde|verdura
ğŸ¥§	torta	apple pie|cibo|dolce|fetta|pasticceria|torta|torta di mele|torta di zucca|tortino
ğŸ¥¨	pretzel	brezel|cibo|pane|pretzel
ğŸ¥©	taglio di carne	bistecca|braciola|carne|carne rossa|cibo|costoletta|costoletta dâ€™agnello|costoletta di maiale|cotoletta|scaloppina|taglio|taglio di carne
ğŸ¥ª	sandwich	cibo|pane|panino|sandwich
ğŸ¥«	cibo in scatola	cibo|cibo in scatola|latta|lattina|scatoletta
ğŸ¥¬	verdure a foglia	bok choy|cavolo|cavolo cinese|cavolo nero|foglia verde|hamburger|insalata|kale|lattuga|verdura|verdure a foglia|verza
ğŸ¥­	mango	cibo|frutta|frutto|mango|shaker|tropicale
ğŸ¥®	torta della luna	autunno|dolce della luna|dolce lunare|festa dâ€™autunno|festival|moon cake|torta lunare|yuebing|yuÃ¨bÇng
ğŸ¥¯	bagel	bagel|ciambella di pane|colazione|pane|panetteria|panificio|spalmare|spalmare formaggio sul bagel
ğŸ¥°	faccina con cuoricini	amore|cotta|cuoricini|faccina|innamoramento|sorriso|ti amo
ğŸ¥±	faccina che sbadiglia	annoiato|assonnato|buona notte|mi annoio|noia|pisolino|sbadigliare|sbadiglio|sonno|stanchezza|stanco|zzz
ğŸ¥²	faccina sorridente con lacrima	commosso|dolore|emozionato|faccina sorridente con lacrima|felice|lacrima|orgoglioso|rincuorato
ğŸ¥³	faccina che festeggia	cappellino|celebrazione|compleanno|entusiasta|faccina che festeggia|festa|festeggiamenti|festeggiamento|festeggiamo|festeggiare|party|si festeggia|trombetta
ğŸ¥´	faccina stordita	alticcio|bocca ondulata|brillo|confuso|frastornato|occhi storti|ubriaco|vertigini
ğŸ¥µ	faccina accaldata	accaldato|bollente|caldo|colpo di calore|febbre|febbricitante|fuoco|lingua di fuori|morendo dal caldo|morire di caldo|sudare|sudore
ğŸ¥¶	faccina congelata	blu|congelare|denti che battono per il freddo|freddo|gelo|ghiaccioli|ghiacciolo|ipotermia|sottozero
ğŸ¥·	ninja	abilitÃ |assassino|combattimento|furtivo|guerra|guerriero|invisibile|nascosto|ninja|persona
ğŸ¥¸	faccina travestita	baffi|faccina|faccina travestita|incognito|naso|occhiali|persona|spia|travestimento
ğŸ¥¹	faccina che trattiene le lacrime	ammirazione|faccina con gli occhi umidi|fiero|gioia|gratitudine|grato|imbarazzato|lacrime|orgoglioso|per favore|piangere|resistere|sentimenti|trattenere|triste
ğŸ¥º	faccina supplichevole	faccina implorante|faccina sullâ€™orlo delle lacrime|lacrime|occhi da cucciolo|occhioni|per favore|per piacere|supplicare|triste
ğŸ¥»	sari	abbigliamento|abito indiano|abito tradizionale indiano|sari|vestito indiano|vestito tradizionale
ğŸ¥¼	camice	abiti|camice|camice bianco|camice da laboratorio|dottore|dottoressa|esperimento|giacca|medico|scienziato
ğŸ¥½	maschera	immersioni|maschera|nuotare|nuoto|occhiali di protezione|occhiali protettivi|occhialini|protezione per gli occhi|saldare|saldatura|sub
ğŸ¥¾	stivale da trekking	campeggio|escursionismo|passeggiata|scarpa|scarponcino|scarpone|scarponi|stivale da trekking|trekking
ğŸ¥¿	ballerina	ballerine|comfort|scarpa bassa|scarpa senza lacci|scarpe da ballerina
ğŸ¦€	granchio	cancro|granchio|mare|mollusco|oceano|segno zodiacale
ğŸ¦	leone	alpha|animale|criniera|forte|forza|muso di leone|oroscopo|roar|ruggito|segno zodiacale|selvaggio|selvatico
ğŸ¦‚	scorpione	animale|scorpione|segno zodiacale
ğŸ¦ƒ	tacchino	animale|giorno del ringraziamento|ringraziamento|tacchino|Thanksgiving
ğŸ¦„	unicorno	faccina|unicorno
ğŸ¦…	aquila	animale|aquila reale|ornitologia|rapace|uccello
ğŸ¦†	anatra	animale|ornitologia|papera|uccello
ğŸ¦‡	pipistrello	ali|animale|notte|pipistrello|vampiro
ğŸ¦ˆ	squalo	aggressivitÃ |animale|animali|pericolo|pesce|squalo
ğŸ¦‰	gufo	animale|animali|bosco|foresta|fortuna|gufo|saggezza|selvatico|uccello
ğŸ¦Š	volpe	animale|bosco|faccina volpe|furbetto|furbizia|furbo|muso di volpe|natura|volpacchiotto
ğŸ¦‹	farfalla	ali|animale|colorata|insetto
ğŸ¦Œ	cervo	animale|animali|bosco|cerbiatto|cervo|corna|primavera|selvatico
ğŸ¦	gorilla	animale|foresta|scimmia|selvatico
ğŸ¦	lucertola	animale|animali|lucertola|rettile
ğŸ¦	rinoceronte	Africa|animale|animali|natura|rinoceronte|safari|savana|selvatico
ğŸ¦	gamberetto	animale|animali|cibo|crostaceo|gamberetto|gambero|mare|oceano
ğŸ¦‘	calamaro	animale|animali|calamaro|cibo|mare|mollusco|oceano|polipo|polpo|totano
ğŸ¦’	giraffa	animale|animali|giraffa|macchie|puntini|savana|selvaggio|selvatico
ğŸ¦“	zebra	animale|animali|bianco|bianconero|nero|strisce|zebra
ğŸ¦”	riccio	animale|animali|riccio|spine|spinoso
ğŸ¦•	sauropode	animale|animali|brachiosauro|brachiosaurus|brontosauro|brontosaurus|dinosauro|diplodoco|diplodocus|sauropode
ğŸ¦–	T-Rex	animale|animali|dinosauro|T-Rex|tirannosauro|Tirannosauro Rex|Tyrannosaurus Rex
ğŸ¦—	grillo	animale|cavalletta|insetto|ortottero
ğŸ¦˜	canguro	animale|animale che salta|Australia|canguro|cucciolo di canguro|marsupiale|saltare
ğŸ¦™	lama	alpaca|animale|guanaco|lama|lana|lana di alpaca|vicuÃ±a|vigogna
ğŸ¦š	pavone	animale|appariscente|colorato|esibizionista|orgoglioso|pavone|pavoneggiarsi|uccello|vistoso|volatile
ğŸ¦›	ippopotamo	animale|ippo|ippopotamo
ğŸ¦œ	pappagallo	animale|pappagallo|parlare|pirata|pirati|uccello|uccello parlante
ğŸ¦	procione	animale|curiositÃ |curioso|furbizia|furbo|procione
ğŸ¦	aragosta	animale|aragosta|aragosta rossa|astice|chele|crostacei|frutti di mare|zuppa
ğŸ¦Ÿ	zanzara	febbre|insetto|malaria|malattia|morso|puntura dâ€™insetto|virus|zanzara
ğŸ¦ 	microbo	ameba|batteri|batterio|microbo|scienza|virus
ğŸ¦¡	tasso	animale|dare fastidio|infastidire|tasso|tasso del miele
ğŸ¦¢	cigno	animale|brutto anatroccolo|cigno|cigno giovane|uccello|volatile
ğŸ¦£	mammut	animale|estinzione|grande|lanoso|mammut|zanna
ğŸ¦¤	dodo	animale|dodo|estinzione|grande|Mauritius|uccello
ğŸ¦¥	bradipo	animale|bradipo|calma|lentezza|lento|pigrizia|pigro
ğŸ¦¦	lontra	animale|giocherellone|lontra|lontra marina|pescare
ğŸ¦§	orangotango	animale|gorilla|orango|orangotango|scimmia|scimmione
ğŸ¦¨	puzzola	animale|puzza|puzzola|puzzolente
ğŸ¦©	fenicottero	animale|fenicottero|flamingo|rosa|tropicale|uccello
ğŸ¦ª	ostrica	alimento|cibo|mollusco|ostrea|ostrica|perla
ğŸ¦«	castoro	animale|castoro|denti|diga|roditore
ğŸ¦¬	bisonte	animale|bisonte|mandria
ğŸ¦­	foca	animale|foca|leone marino|mare|oceano|otaria
ğŸ¦®	cane guida	accessibilitÃ |animale|cane|cane da accompagnamento|cane guida|cieco|non vedente|non vedenti
ğŸ¦¯	bastone per non vedenti	accessibilitÃ |bastone bianco|bastone per ciechi|bastone per ipovedenti|bastone per non vedenti
ğŸ¦´	osso	cane|ossa|osso|osso a forchetta|scheletro
ğŸ¦µ	gamba	arto|calcio|gamba|gamba piegata|ginocchio|ginocchio piegato|piede|polpaccio
ğŸ¦¶	piede	calciare|calcio|calpestare|camminare|camminare con passo pesante|caviglia|piede|piedi
ğŸ¦·	dente	bianchi|bianco|dente|denti|dentista|perlacei|perlaceo
ğŸ¦¸	supereroe	bene|buono|eroe|eroina|persona|personaggio|supereroe|supereroina|superman|superpotere|superpoteri
ğŸ¦¹	supercattivo	cattivo|criminale|malvagio|persona|personaggio|supercattivo|superpotere|superpoteri
ğŸ¦º	gilet di sicurezza	antinfortunistica|emergenza|gilet antinfortunistica|gilet catarifrangente|gilet di sicurezza
ğŸ¦»	orecchio con apparecchio acustico	accessibilitÃ |apparecchio acustico|non udente|non udenti|orecchio|orecchio con apparecchio acustico|protesi acustica|sorditÃ |sordo
ğŸ¦¼	sedia a rotelle motorizzata	accessibilitÃ |carrozzina motorizzata|sedia a rotelle motorizzata
ğŸ¦½	sedia a rotelle manuale	accessibilitÃ |carrozzina manuale|sedia a rotelle manuale
ğŸ¦¾	protesi robotica per il braccio	accessibilitÃ |braccio meccanico|protesi|protesi robotica per il braccio
ğŸ¦¿	protesi robotica per la gamba	accessibilitÃ |gamba meccanica|protesi|protesi robotica per la gamba
ğŸ§€	fetta di formaggio	cibo|fetta di formaggio|formaggio|gruviera
ğŸ§	cupcake	cupcake|delizia|dessert|dolce|festa|panetteria|panificio|pasticceria|tortina|zucchero
ğŸ§‚	sale	condimento|gusto|salato|sale|saliera|sapore|saporito
ğŸ§ƒ	bevanda monodose	bevanda|bevanda in brick|bevanda monodose|brick|cannuccia|succo|succo di frutta in cartone
ğŸ§„	aglio	aglio|alimento|cibo|condimento|insaporire|insaporitore|spicchio dâ€™aglio
ğŸ§…	cipolla	alimento|cibo|cipolla|insaporire|insaporitore|piangere|soffritto
ğŸ§†	falafel	ceci|cibo|falafel|felafel|polpetta|polpette di ceci
ğŸ§‡	waffle	cialda|cibo|colazione|gaufre|waffle
ğŸ§ˆ	burro	alimento|burro|cibo|latticini|latticino
ğŸ§‰	mate	bevanda|erba Mate|mate|mate argentino
ğŸ§Š	cubetto di ghiaccio	cubetto di ghiaccio|freddo|gelo|ghiaccio|ghiaccio in cubetti|ghiaccio in cubi
ğŸ§‹	bubble tea	bibita|boba|bolla|bolle|bubble tea|cibo|latte|perla|sfera|Taiwan|tÃ¨ con le bolle|thÃ¨
ğŸ§Œ	troll	fantasia|favola|fiaba|mostro|troll
ğŸ§	persona in piedi	in piedi|persona|persona in piedi|stare fermi|stare in piedi
ğŸ§	persona inginocchiata	in ginocchio|inginocchiarsi|meditare|meditazione|persona|persona inginocchiata
ğŸ§	persona con problemi di udito	accessibilitÃ |difficoltÃ  uditive|non sentire|orecchio|persona|persona con problemi di udito|problemi di udito|sorditÃ |sordo|udito
ğŸ§	faccina con monocolo	antico|classe|faccina|faccina con monocolo|fighetto|monocolo|occhiale|ricco|sospetto
ğŸ§‘	persona	adulta|adulto|persona
ğŸ§‘â€ğŸŒ¾	agricoltore	agricoltore|allevatore|contadino|giardiniere
ğŸ§‘â€ğŸ³	persona che cucina	chef|cuoco|persona che cucina
ğŸ§‘â€ğŸ¼	persona che allatta	allattamento|babysitter|bebÃ¨|mamma|neonato|nutrire|papÃ |persona|persona che allatta
ğŸ§‘â€ğŸ„	Santa Claus	Babbo Natale|buon Natale|cappello di Babbo Natale|Claus|Natale|persona|Santa Claus|vacanze di Natale
ğŸ§‘â€ğŸ“	studente	diploma|studente|studentessa
ğŸ§‘â€ğŸ¤	cantante	attore|cantante|intrattenitore|rock|star
ğŸ§‘â€ğŸ¨	artista	artista|tavolozza
ğŸ§‘â€ğŸ«	insegnante	insegnante|maestra|maestro|professore|professoressa
ğŸ§‘â€ğŸ­	persona che lavora in fabbrica	assemblaggio|fabbrica|industria|operaio|persona che lavora in fabbrica
ğŸ§‘â€ğŸ’»	persona esperta di tecnologia	inventore|persona esperta di tecnologia|programmatore|software|sviluppatore|tecnologo
ğŸ§‘â€ğŸ’¼	persona che fa un lavoro dâ€™ufficio	architetto|business|impiegato|manager|persona che fa un lavoro dâ€™ufficio
ğŸ§‘â€ğŸ”§	meccanico	elettricista|idraulico|meccanico|tecnico specializzato
ğŸ§‘â€ğŸ”¬	persona che lavora in campo scientifico	biologo|chimico|fisico|ingegnere|persona che lavora in campo scientifico|scienziato
ğŸ§‘â€ğŸš€	astronauta	astronauta|razzo
ğŸ§‘â€ğŸš’	pompiere	pompiere|vigile del fuoco
ğŸ§‘â€ğŸ¤â€ğŸ§‘	persone che si tengono per mano	coppia|coppia che si tiene per mano|coppia per mano|insieme|mano nella mano|persona|persone che si tengono per mano|tenersi per mano|uniti
ğŸ§‘â€ğŸ¦¯	persona con bastone di orientamento	accessibilitÃ |cecitÃ |persona con bastone di orientamento
ğŸ§‘â€ğŸ¦¼	persona su sedia a rotelle motorizzata	accessibilitÃ |persona su sedia a rotelle motorizzata|sedia a rotelle
ğŸ§‘â€ğŸ¦½	persona su sedia a rotelle manuale	accessibilitÃ |persona su sedia a rotelle manuale|sedia a rotelle
ğŸ§‘â€ğŸ§‘â€ğŸ§’	famiglia: persone adulte, minore	famiglia|minore|persona adulta
ğŸ§‘â€ğŸ§‘â€ğŸ§’â€ğŸ§’	famiglia: persone adulte, minori	famiglia: persona adulta|famiglia: persona adulta, persona adulta, minore, minore|minore|persona adulta
ğŸ§‘â€ğŸ§’	famiglia: persona adulta, minore	famiglia: persona adulta|famiglia: persona adulta, minore|minore
ğŸ§‘â€ğŸ§’â€ğŸ§’	famiglia: persona adulta, minore, minore	famiglia: persona adulta|famiglia: persona adulta, minore, minore|minore
ğŸ§’	bimbo	bambina|bambino|bimba|bimbo|giovane|persona|ragazzina|ragazzino
ğŸ§“	persona anziana	adulto anziano|anziana|anziano|persona|vecchia|vecchio
ğŸ§”	persona con la barba	baffi|barba|barbuto|persona|persona con barba|persona con la barba
ğŸ§•	donna con velo	copricapo|donna|donna con foulard|donna con hijab|donna con velo|hijab|islam|velo
ğŸ§–	persona in sauna	bagno turco|benessere|hammam|persona|persona in sauna|persona nella sauna|relax|sauna|spa
ğŸ§—	persona che scala	arrampicarsi|arrampicata|arrampicatore|arrampicatrice|montagna|persona|persona che arrampica|persona che scala|roccia|scalatore|sport
ğŸ§˜	persona in posizione del loto	gambe incrociate|meditazione|pace|persona|persona che fa yoga|persona in posizione del loto|relax|rilassarsi|yoga|zen
ğŸ§™	mago	barba|cappello|incantesimo|maghetto|magia|magico|mago|strega|stregone
ğŸ§š	fata	ali|creatura|fata|fatina|fiaba|folletto|Oberon|Puck|regina delle fate|Titania
ğŸ§›	vampiro	costume|creatura|denti|Dracula|halloween|maschera|morte|morto vivente|paura|sangue|supernaturale|vampiro
ğŸ§œ	sirena	creatura|donna sirena|fiaba|mare|mitologia|oceano|personaggio|pesce|sirena|sirenetta
ğŸ§	elfo	creatura|elfetto|elfo|fantasy|fiaba|folclore|magia|magico
ğŸ§	genio	aladino|creatura|desideri|djinn|fiaba|genietto|genio|jinn|lampada|personaggio
ğŸ§Ÿ	zombie	carnevale|halloween|horror|morte|morto vivente|paura|scheletro|spaventoso|urlo|zombie
ğŸ§ 	cervello	cervello|corpo umano|intelligente|parte del corpo
ğŸ§¡	cuore arancione	amore|arancione|cuore|cuore arancio|emozione
ğŸ§¢	cappello con visiera	abbigliamento|baseball|cappellino|cappellino da baseball|cappello|cappello con visiera|cappello da baseball|indumenti|vestiti
ğŸ§£	sciarpa	abbigliamento|collo|freddo|inverno|sciarpa|sciarpetta|sciarpina
ğŸ§¤	guanti	blu|guanti|guanto|mano
ğŸ§¥	cappotto	abbigliamento|cappotto|freddo|giacca|giaccone|giubbotto|inverno|rosso
ğŸ§¦	calzini	abbigliamento|calze|calzette|calzini
ğŸ§§	busta hongbao	buona fortuna|buono auspicio|busta rossa|busta soldi|denaro|hÃ³ngbÄo|lai see|regalo|soldi
ğŸ§¨	petardo	botto|dinamite|esplodere|esplosivo|far esplodere|fuochi artificiali|fuochi dâ€™artificio|petardo|scintilla|scoppiare|scoppio
ğŸ§©	pezzo di puzzle	incastrarsi|incastro|indizio|pezzo|pezzo di puzzle|pezzo mancante|puzzle|tassello|tessera del puzzle
ğŸ§ª	provetta	chimica|chimico|esperimenti|esperimento|laboratorio|provetta|scienza
ğŸ§«	piastra di Petri	batteri|batterio|biologa|biologia|biologo|capsula di petri|coltura|cultura|laboratorio|piastra di petri|piastra di Petri
ğŸ§¬	dna	biologo|dna|evoluzione|gene|genetica|geni|vita
ğŸ§­	bussola	bussola|direzione|magnetica|navigazione|orientamento
ğŸ§®	abaco	abaco|abbaco|calcolare|calcolatrice|calcolo|fare i calcoli|pallottoliere
ğŸ§¯	estintore	estinguere|estintore|fiamme|fuoco|incendio|raffreddare|spegnere|spegnere un incendio
ğŸ§°	cassetta degli attrezzi	attrezzi|attrezzo|cassetta|cassetta degli attrezzi|cassetta per gli attrezzi|meccanico|strumenti|strumento
ğŸ§±	mattoni	argilla|malta|mattone|mattoni|muro|muro di mattoni
ğŸ§²	calamita	a forma di u|attrazione|calamita|ferro di cavallo|magnete|magnetica|magnetico|positivo negativo
ğŸ§³	valigia	bagagli|bagaglio|partenza|partiamo|preparare il bagaglio|preparazione dei bagagli|si parte|trolley|valigia|viaggiare|viaggio
ğŸ§´	flacone	bottiglia di crema|bottiglia di lozione|crema|crema idratante|crema solare|filtro solare|flacone|lozione|lozione solare|shampoo
ğŸ§µ	filo	ago|bobina|corda|cucire|filo|rocchetto|rotolo
ğŸ§¶	gomitolo	fare a maglia|filo|gomitolo|lavorare a maglia|palla|sferruzzare|uncinetto
ğŸ§·	spilla da balia	pannolone|punk rock|spilla da balia|spilla di sicurezza
ğŸ§¸	orsetto	giocattolo|imbottito|orsacchiotto|orsacchiotto di peluche|orsetto|orsetto di peluche|orso|peluche|soffice|teddy bear
ğŸ§¹	scopa	pulire|scopa|scopare|spazzare|strega
ğŸ§º	cesto	biancheria|bucato|cestino|cesto|orto|picnic
ğŸ§»	rotolo di carta igienica	asciugamani di carta|carta assorbente|carta igienica|rotolo|rotolo di carta|rotolo di carta igienica|scottex
ğŸ§¼	sapone	bagno|fare il bagno|insaponare|lavarsi|pulito|pulizia|sapone|saponetta|schiuma
ğŸ§½	spugna	assorbenza|assorbire|bagnare|poroso|pulire|pulizia|spugna|spugna porosa|spugnetta
ğŸ§¾	scontrino	contabilitÃ |fattura|invoice|prova|ricevuta|ricevuta di pagamento|scontrino|tenuta dei libri
ğŸ§¿	occhio di Allah	amuleto|amuleto di nazar|blu|malocchio|nazar|occhio di Allah|occhio di nazar|perlina|portafortuna|talismano
ğŸ©°	scarpette da ballerina	balletto|danza|danza classica|scarpette da ballerina|scarpette da ballo
ğŸ©±	costume da bagno intero	abbigliamento|costume da bagno|costume da bagno intero|costume da donna|costume intero
ğŸ©²	slip	costume da bagno maschile|costume da uomo|intimo|mutande da uomo|slip
ğŸ©³	pantaloncini	abbigliamento|boxer|costume da bagno maschile|costume da uomo|intimo|mutande da uomo|pantaloncini|shorts
ğŸ©´	infradito	abbigliamento|ciabatte|infradito|mare|sandali|scarpe|spiaggia
ğŸ©µ	cuore azzurro	affetto|amore|azzurro|celeste|cuore|emozione
ğŸ©¶	cuore grigio	amore|ardesia|argento|cuore|emozione|grigio
ğŸ©·	cuore rosa	affetto|amore|cuore|emozione|rosa
ğŸ©¸	goccia di sangue	ciclo mestruale|donare il sangue|donazione di sangue|goccia di sangue|medicina|medicinale|mestruazioni
ğŸ©¹	cerotto	cerotto|cerotto adesivo
ğŸ©º	stetoscopio	cardiologo|dottore|dottoressa|fonendoscopio|medico|stetoscopio
ğŸ©»	radiografia	dottore|lastra|medico|ossa|radiografia|raggi x|scheletro
ğŸ©¼	stampella	ausilio|bastone|disabile|ferito|infortunio|oggetto|stampella|supporto|zoppicare
ğŸª€	yo-yo	giocattolo|rocchetto|yo-yo|yoyo
ğŸª	aquilone	aquilone|planare|vento|volare|volo
ğŸª‚	paracadute	parÃ |paracadute|paracadute ascensionale|paracadutismo|paracadutista|parasailing|skydiving|sport
ğŸªƒ	boomerang	aborigeni|arma|australia|boomerang|oggetto|rimbalzo|ripercussione
ğŸª„	bacchetta magica	abracadabra|bacchetta magica|formula magica|incantesimo|maga|magia|mago|strega|stregone
ğŸª…	pentolaccia	caramelle|divertimento|dolcetti|festa|gioco della pentolaccia|gioco della pignatta|pentolaccia|pignatta
ğŸª†	matrioska	bambola|bambola di legno|bambola russa|matriosca|matrioska|russia
ğŸª‡	maracas	agitare|ballare|maracas|musica|percussioni|ritmo|scuotere|strumento
ğŸªˆ	flauto	fiati|fiato|flautista|flauto|legno|musica|pifferaio|piffero|strumento|zufolo
ğŸª‰	arpa	amore|arpa|cupido|musica|orchestra|strumento
ğŸª	vanga	buco|pala|scavare|spalare|vanga
ğŸª	pianeta con satellite	corpo celeste|pianeta con anelli|pianeta con satellite|satellite|Saturno|spazio
ğŸª‘	sedia	mettersi seduti|mobile|sedersi|sedia|seduti|seggiola
ğŸª’	rasoio	farsi la barba|lama da barba|lama da barbiere|lametta da barba|radersi|rasoio|rasoio da barbiere
ğŸª“	ascia	accetta|ascia|boscaiolo|taglialegna
ğŸª”	diya	deepak|deepam|divaa|diya|lampada a olio|lampada a olio tradizionale
ğŸª•	banjo	banjo|musica|strumento a corde
ğŸª–	elmetto militare	caschetto|elmetto|esercito|guerra|militare|oggetto|soldato
ğŸª—	fisarmonica	concertina|fisarmonica|musica|organetto|strumento musicale
ğŸª˜	tamburo lungo	bongo|conga|musica|percussioni|ritmo|strumento musicale|tamburo|tamburo lungo
ğŸª™	moneta	argento|denaro|dollaro|euro|metallo|moneta|oro|ricco|soldi|tesoro
ğŸªš	sega da falegname	falegname|legname|legno|oggetto|sega|sega da falegname|segare|tagliare|utensile
ğŸª›	cacciavite	avvitare|cacciavite|oggetto|svitare|utensile|vite
ğŸªœ	scala	arrampicarsi|oggetto|piolo|scala|scala a pioli|scalino
ğŸª	gancio	amo|curva|fermaglio|gancio|impigliarsi|intrappolare|oggetto|punto vendita|uncino
ğŸª	specchio	oggetto|riflesso|specchio|trucco
ğŸªŸ	finestra	apertura|aria fresca|finestra|oggetto|telaio|trasparente|vista
ğŸª 	sturalavandini	aspirazione|bagno|idraulico|ingorgo|intasamento|oggetto|scarico|sturalavandini|ventosa
ğŸª¡	ago da cucito	ago|ago da cucito|attivitÃ |cucito|punti|ricamo|sarta|sarto|sartoria|suture
ğŸª¢	nodo	annodato|corda|fune|legare|nodo|spago
ğŸª£	secchio	contenitore|oggetto|secchia|secchio
ğŸª¤	trappola per topi	esca|formaggio|oggetto|topo|trappola|trappola per topi
ğŸª¥	spazzolino da denti	bagno|dentale|denti|igiene|lavarsi i denti|oggetto|pulito|pulizia|spazzolino|spazzolino da denti
ğŸª¦	lapide	cimitero|lapide|morto|pietra tombale|RIP|sepoltura|tomba
ğŸª§	cartello	cartello|corteo|manifestazione|manifesto|oggetto|picchetto|protesta|striscione
ğŸª¨	roccia	duro|macigno|masso|pesante|pietra|roccia|sasso|solido
ğŸª©	palla da discoteca	ballare|brillare|dance|disco|discoteca|festa|glitter|palla a specchio|palla da discoteca|party|specchi
ğŸªª	carta dâ€™identitÃ 	badge|carta dâ€™identitÃ |credenziali|documento dâ€™identitÃ |identificazione|patente|sicurezza|tessera
ğŸª«	batteria scarica	batteria scarica|elettronica|energia bassa|esausta|esausto|pila scarica|ricarica
ğŸª¬	mano di Fatima	amuleto|fortuna|hamsa|khamsa|Mano con lâ€™occhio divino|Mano di ALO|mano di Fatima|Maria|Miriam|protezione
ğŸª­	ventaglio	afa|aria|caldo|rinfrescare|sventagliare|sventolare|timidezza|ventaglio
ğŸª®	pettine afro	afro|capelli|pettinatura|pettine
ğŸª¯	khanda	khanda|religione|Sikh|sikhismo
ğŸª°	mosca	animale|decomposizione|infestante|insetto|insetto volante|larva|malattia|mosca|moscone|volare
ğŸª±	verme	anellide|animale|lombrico|parassita|strisciare|verme
ğŸª²	coleottero	animale|cimice|coleottero|insetto|scarabeo
ğŸª³	scarafaggio	animale|blatta|disgustoso|infestante|insetto|scarafaggio
ğŸª´	pianta in vaso	casa|coltivare|curare|decorare|inutile|noioso|pianta|pianta in vaso|vaso|verde
ğŸªµ	legna	ceppo|ciocco|legna|legname|legno|tronco
ğŸª¶	piuma	leggero|penna|piuma|piumaggio|uccello|volo
ğŸª·	loto	bellezza|buddhismo|fior di loto|fiore|India|induismo|loto|purezza|serenitÃ |Vietnam|yoga
ğŸª¸	corallo	barriera|barriera corallina|cambiamento climatico|corallo|mare|oceano
ğŸª¹	nido vuoto	nidificazione|nido|nido vuoto
ğŸªº	nido con uova	nidificazione|nido|nido con uova|nido di uccelli|uccelli|uova
ğŸª»	giacinto	bocca di leone|fiore|giacinto|lavanda|lupino|primavera
ğŸª¼	medusa	animale|bruciatura|dolore|invertebrato|mare|medusa|puntura|trasparente|urticante
ğŸª½	ala	ala|angelo|aviazione|mitologia|uccello|volare
ğŸª¾	albero spoglio	inverno|senza foglie|siccitÃ 
ğŸª¿	oca	animale|oca|papera|pollame|starnazzare|stupiditÃ |uccello
ğŸ«€	organo del cuore	anatomia|battito|cardiologia|cuore|cuore vero|organo|organo del cuore|pulsazione|rosso
ğŸ«	polmoni	espirazione|inspirazione|organo|polmoni|respirazione|respiro
ğŸ«‚	persone che si abbracciano	abbraccio|addio|amicizia|amore|ciao|confortare|consolare|grazie|persone|persone che si abbracciano
ğŸ«ƒ	uomo incinto	gonfio|gravido|incinto|pancia|pieno|troppo cibo|uomo
ğŸ«„	persona incinta	gonfio|gravido|incinta|incinto|pancia|persona incinta|pieno|troppo cibo
ğŸ«…	persona con corona	monarca|nobile|persona con corona|re|reale|regale|regina
ğŸ«†	impronta digitale	identitÃ |impronta digitale|indizio|riconoscimento biometrico|scienza forense|sicurezza|traccia
ğŸ«	alce	alce|animale|corna|mammifero
ğŸ«	asino	animale|asino|mammifero|mulo|somaro|testardo
ğŸ«	mirtilli	bacca|blu|cibo|frutta|frutti di bosco|mirtilli|mirtillo
ğŸ«‘	peperone	cibo|ortaggio|peperone|peperone verde|verdure
ğŸ«’	oliva	cibo|olio|oliva|ramo di ulivo|ulivo
ğŸ«“	focaccia	arepa|cibo|focaccia|lavash|naan|pane|piadina|pita|tigella
ğŸ«”	tamale	cibo|involtino|messicano|pamonha|tamale
ğŸ«•	fonduta	cibo|cioccolato|fonduta|formaggio|fuso|pentola|sci
ğŸ«–	teiera	bere|cibo|tÃ¨|teiera|thÃ¨
ğŸ«—	liquido versato	bevanda|bicchiere|bicchiere rovesciato|drink|liquido versato|rovesciare|svuotare|versare
ğŸ«˜	fagioli	cibo|fagioli|legume
ğŸ«™	barattolo	barattolo|condimento|conservare|contenitore|dispensa|salsa|sugo|vuoto
ğŸ«š	radice di zenzero	birra|radice|radice di zenzero|salute|spezia|zenzero
ğŸ«›	baccello di piselli	baccello|baccello di piselli|cibo|edamame|legume|pisello|vegetale|verdura
ğŸ«œ	ortaggio da radice	barbabietola|orto|radice|rapa|vegetale
ğŸ«Ÿ	spruzzo	chiazza|holi|pittura|rovesciare|schizzo|vernice
ğŸ« 	faccina che si scioglie	afa|caldo|dissolversi|faccina che si scioglie|liquefarsi|liquido|sciogliendo|sciogliersi|sciolto|sparire|squagliando|squagliarsi
ğŸ«¡	faccina che fa il saluto	agli ordini|dâ€™accordo|faccina che fa il saluto militare|militare|obbedisco|ok|saluto|signorsÃ¬|sissignora|sissignore|truppe|va bene
ğŸ«¢	faccina con occhi aperti e mano sulla bocca	imbarazzo|incredibile|incredulitÃ |meraviglia|non ci credo|non ci posso credere|ops|sconvolto|shock|sorpresa|spavento|stupore
ğŸ«£	faccina che sbircia tra le dita	curiositÃ |faccina che sbircia tra le dita|fissare|imbarazzo|incuriosito|nascondo|sbirciare|sbircio|spiare|timida|timido
ğŸ«¤	faccina perplessa	confuso|cosÃ¬ cosÃ¬|deluso|dubbioso|faccina perplessa|mah|meh|perplesso|scettico
ğŸ«¥	faccina tratteggiata	depresso|faccina tratteggiata|introverso|invisibile|nascondersi|scomparire|sparire
ğŸ«¦	bocca che morde il labbro	ansia|bocca che morde il labbro|bocca con rossetto|disagio|flirtare|labbra con denti|nervoso|paura|preoccupato|sedurre|seduzione|sexy
ğŸ«§	bolle	bolle|bollicine|perle|pulito|rutto|sapone|schiuma|sottâ€™acqua|subacqueo
ğŸ«¨	faccina tremante	faccina|faccina che trema|faccina scossa|scombussolato|scosso|scossone|shock|terremoto|tremante|tremare|vibrazione
ğŸ«©	faccina con borse sotto gli occhi	assonnato|borse|esausto|occhiaie|sfinito|sonno|stanchezza|stanco
ğŸ«°	mano con indice e pollice incrociati	amore|caro|costa|costoso|cuore|denaro|mano|mano con indice e pollice incrociati|schioccare|soldi
ğŸ«±	mano rivolta a destra	dare la mano|destra|mano|mano rivolta a destra|verso destra
ğŸ«²	mano rivolta a sinistra	dare la mano|mano|mano destra rivolta a sinistra|mano rivolta a sinistra|sinistra|verso sinistra
ğŸ«³	mano con il palmo verso il basso	afferrare|allontanare|cacciare|congedare|imporre|lasciar cadere|mano|mano con il palmo verso il basso|porgere la mano|scacciare|sciÃ²
ğŸ«´	mano con il palmo verso lâ€™alto	elemosina|mano|mano con il palmo verso lâ€™alto|offrire|prendere|raccogliere|richiamare|sollevare|vieni qui
ğŸ«µ	indice verso lâ€™osservatore	dito puntato|indicare|indice puntato|indice verso lâ€™osservatore|mano|puntare|tu
ğŸ«¶	mani a cuore	amore|cuore|mani a cuore|mano|ti amo|ti voglio bene
ğŸ«·	mano che spinge a sinistra	alt|aspettare|batti cinque|fermare|indietro|mano che spinge verso sinistra|palmo|rifiutare|sinistra|spingere|spinta|stop
ğŸ«¸	mano che spinge a destra	alt|aspettare|batti cinque|destra|fermare|indietro|mano che spinge verso destra|palmo|rifiutare|spingere|spinta|stop
