‚åö	–Ω–∞—Ä—É—á–Ω–∏–π –≥–æ–¥–∏–Ω–Ω–∏–∫	–≥–æ–¥–∏–Ω–Ω–∏–∫|–Ω–∞—Ä—É—á–Ω–∏–π –≥–æ–¥–∏–Ω–Ω–∏–∫
‚åõ	–ø—ñ—Å–∫–æ–≤–∏–π –≥–æ–¥–∏–Ω–Ω–∏–∫	–≤—ñ–¥–ª—ñ–∫ —á–∞—Å—É|–ø—ñ—Å–∫–æ–≤–∏–π –≥–æ–¥–∏–Ω–Ω–∏–∫|–ø—ñ—Å–æ–∫|–ø—ñ—Å–æ—á–Ω–∏–π –≥–æ–¥–∏–Ω–Ω–∏–∫|—Ç–∞–π–º–µ—Ä
‚è©	–∫–Ω–æ–ø–∫–∞ –ø–µ—Ä–µ–º–æ—Ç—É–≤–∞–Ω–Ω—è –≤–ø–µ—Ä–µ–¥	–≤–ø–µ—Ä–µ–¥|–¥–≤—ñ|–∫–Ω–æ–ø–∫–∞ ¬´–ü–µ—Ä–µ–º–æ—Ç–∞—Ç–∏ –≤–ø–µ—Ä–µ–¥¬ª|–∫–Ω–æ–ø–∫–∞ –º–æ—Ç–∞–Ω–Ω—è –≤–ø–µ—Ä–µ–¥|–∫–Ω–æ–ø–∫–∞ –ø–µ—Ä–µ–º–æ—Ç—É–≤–∞–Ω–Ω—è –≤–ø–µ—Ä–µ–¥|–ø–µ—Ä–µ–º–æ—Ç–∞—Ç–∏|—Å—Ç—Ä—ñ–ª–∫–∞
‚è™	–∫–Ω–æ–ø–∫–∞ –ø–µ—Ä–µ–º–æ—Ç—É–≤–∞–Ω–Ω—è –Ω–∞–∑–∞–¥	–¥–≤—ñ|–∫–Ω–æ–ø–∫–∞ ¬´–®–≤–∏–¥–∫–æ –Ω–∞–∑–∞–¥¬ª|–∫–Ω–æ–ø–∫–∞ –º–æ—Ç–∞–Ω–Ω—è –Ω–∞–∑–∞–¥|–∫–Ω–æ–ø–∫–∞ –ø–µ—Ä–µ–º–æ—Ç—É–≤–∞–Ω–Ω—è –Ω–∞–∑–∞–¥|–ø–µ—Ä–µ–º–æ—Ç–∞—Ç–∏|–ø–æ–¥–≤—ñ–π–Ω–∞ —Å—Ç—Ä—ñ–ª–∫–∞ –Ω–∞–∑–∞–¥|—Å—Ç—Ä—ñ–ª–∫–∞
‚è´	–∫–Ω–æ–ø–∫–∞ –º–æ—Ç–∞–Ω–Ω—è –≤–≥–æ—Ä—É	–¥–≤—ñ|–∫–Ω–æ–ø–∫–∞ ¬´–®–≤–∏–¥–∫–æ –≤–≥–æ—Ä—É¬ª|–∫–Ω–æ–ø–∫–∞ –º–æ—Ç–∞–Ω–Ω—è –≤–≥–æ—Ä—É|–ø–æ–¥–≤—ñ–π–Ω–∞ —Å—Ç—Ä—ñ–ª–∫–∞|—Å—Ç—Ä—ñ–ª–∫–∞
‚è¨	–∫–Ω–æ–ø–∫–∞ –º–æ—Ç–∞–Ω–Ω—è –≤–Ω–∏–∑	–≤–Ω–∏–∑|–¥–≤—ñ|–∫–Ω–æ–ø–∫–∞ ¬´–®–≤–∏–¥–∫–æ –≤–Ω–∏–∑¬ª|–∫–Ω–æ–ø–∫–∞ –º–æ—Ç–∞–Ω–Ω—è –≤–Ω–∏–∑|—Å—Ç—Ä—ñ–ª–∫–∞|—Å—Ç—Ä—ñ–ª–∫–∏ –¥–æ–Ω–∏–∑—É
‚è∞	–±—É–¥–∏–ª—å–Ω–∏–∫	–±—É–¥–∏–ª—å–Ω–∏–∫|–≥–æ–¥–∏–Ω–Ω–∏–∫
‚è≥	–ø—ñ—Å–∫–æ–≤–∏–π –≥–æ–¥–∏–Ω–Ω–∏–∫ —ñ–∑ –ø—ñ—Å–∫–æ–º, —è–∫–∏–π —Å–∏–ø–ª–µ—Ç—å—Å—è	–≥–æ–¥–∏–Ω–∏|–≥–æ—Ç–æ–≤–æ|–∂–∏—Ç—Ç—è –æ–¥–Ω–µ|–Ω–µ|–æ—á—ñ–∫—É–≤–∞–Ω–Ω—è|–ø—ñ—Å–∫–æ–≤–∏–π –≥–æ–¥–∏–Ω–Ω–∏–∫|–ø—ñ—Å–æ–∫|—Å–∏–ø–∞–Ω–Ω—è|—Ç–∞–π–º–µ—Ä
‚óΩ	–º–µ–Ω—à–∏–π –∑–∞ —Å–µ—Ä–µ–¥–Ω—ñ–π –±—ñ–ª–∏–π –∫–≤–∞–¥—Ä–∞—Ç	–±—ñ–ª–∏–π –∫–≤–∞–¥—Ä–∞—Ç|–≥–µ–æ–º–µ—Ç—Ä–∏—á–Ω–∏–π|–∫–≤–∞–¥—Ä–∞—Ç|–º–µ–Ω—à–∏–π –∑–∞ —Å–µ—Ä–µ–¥–Ω—ñ–π –±—ñ–ª–∏–π –∫–≤–∞–¥—Ä–∞—Ç
‚óæ	–º–µ–Ω—à–∏–π –∑–∞ —Å–µ—Ä–µ–¥–Ω—ñ–π —á–æ—Ä–Ω–∏–π –∫–≤–∞–¥—Ä–∞—Ç	–≥–µ–æ–º–µ—Ç—Ä–∏—á–Ω–∏–π|–∫–≤–∞–¥—Ä–∞—Ç|–º–µ–Ω—à–∏–π –∑–∞ —Å–µ—Ä–µ–¥–Ω—ñ–π —á–æ—Ä–Ω–∏–π –∫–≤–∞–¥—Ä–∞—Ç|—á–æ—Ä–Ω–∏–π –∫–≤–∞–¥—Ä–∞—Ç
‚òî	–ø–∞—Ä–∞—Å–æ–ª—å–∫–∞ –∑ –∫—Ä–∞–ø–ª—è–º–∏ –¥–æ—â—É	–¥–æ—â|–∫—Ä–∞–ø–ª—è|–æ–¥—è–≥|–ø–∞—Ä–∞—Å–æ–ª—å–∫–∞|–ø–∞—Ä–∞—Å–æ–ª—å–∫–∞ –∑ –∫—Ä–∞–ø–ª—è–º–∏ –¥–æ—â—É|–ø–æ–≥–æ–¥–∞
‚òï	–≥–∞—Ä—è—á–∏–π –Ω–∞–ø—ñ–π	–≥–∞—Ä—è—á–∏–π|–∫–∞–≤–∞|–∫–∞—Ñ–µ|–∫–æ—Ñ–µ—ó–Ω|–Ω–∞–ø—ñ–π|–ø–∞—Ä—É—é—á–∏–π|–ø–∏—Ç–∏|—Å–Ω—ñ–¥–∞–Ω–æ–∫|—á–∞–π
‚ôà	–û–≤–µ–Ω	–±–∞—Ä–∞–Ω|–≥–æ—Ä–æ—Å–∫–æ–ø|–∑–Ω–∞–∫ –∑–æ–¥—ñ–∞–∫—É|–∑–æ–¥—ñ–∞–∫|–æ–≤–µ–Ω|–û–≤–µ–Ω
‚ôâ	–¢–µ–ª–µ—Ü—å	–±–∏–∫|–≤—ñ–ª|–≥–æ—Ä–æ—Å–∫–æ–ø|–∑–Ω–∞–∫ –∑–æ–¥—ñ–∞–∫—É —Ç–µ–ª–µ—Ü—å|–∑–æ–¥—ñ–∞–∫|—Ç–µ–ª–µ—Ü—å|–¢–µ–ª–µ—Ü—å
‚ôä	–ë–ª–∏–∑–Ω—é–∫–∏	–±–ª–∏–∑–Ω—é–∫–∏|–ë–ª–∏–∑–Ω—é–∫–∏|–≥–æ—Ä–æ—Å–∫–æ–ø|–∑–æ–¥—ñ–∞–∫
‚ôã	–†–∞–∫	–≥–æ—Ä–æ—Å–∫–æ–ø|–∑–Ω–∞–∫ –∑–æ–¥—ñ–∞–∫—É|–∑–æ–¥—ñ–∞–∫|–∫—Ä–∞–±|—Ä–∞–∫|–†–∞–∫
‚ôå	–õ–µ–≤ (–∑–Ω–∞–∫ –∑–æ–¥—ñ–∞–∫—É)	–≥–æ—Ä–æ—Å–∫–æ–ø|–∑–æ–¥—ñ–∞–∫|–ª–µ–≤|–õ–µ–≤|–õ–µ–≤ (–∑–Ω–∞–∫ –∑–æ–¥—ñ–∞–∫—É)
‚ôç	–î—ñ–≤–∞	–≥–æ—Ä–æ—Å–∫–æ–ø|–¥—ñ–≤–∞|–î—ñ–≤–∞|–∑–æ–¥—ñ–∞–∫
‚ôé	–¢–µ—Ä–µ–∑–∏	–≥–æ—Ä–æ—Å–∫–æ–ø|–∑–Ω–∞–∫ –∑–æ–¥—ñ–∞–∫—É —Ç–µ—Ä–µ–∑–∏|–∑–æ–¥—ñ–∞–∫|—Ä—ñ–≤–Ω–æ–≤–∞–≥–∞|—Å–ø—Ä–∞–≤–µ–¥–ª–∏–≤—ñ—Å—Ç—å|—Ç–µ—Ä–µ–∑–∏|–¢–µ—Ä–µ–∑–∏
‚ôè	–°–∫–æ—Ä–ø—ñ–æ–Ω (–∑–Ω–∞–∫ –∑–æ–¥—ñ–∞–∫—É)	–≥–æ—Ä–æ—Å–∫–æ–ø|–∑–Ω–∞–∫ –∑–æ–¥—ñ–∞–∫—É —Å–∫–æ—Ä–ø—ñ–æ–Ω|–∑–æ–¥—ñ–∞–∫|—Å–∫–æ—Ä–ø—ñ–æ–Ω|–°–∫–æ—Ä–ø—ñ–æ–Ω (–∑–Ω–∞–∫ –∑–æ–¥—ñ–∞–∫—É)
‚ôê	–°—Ç—Ä—ñ–ª–µ—Ü—å	–≥–æ—Ä–æ—Å–∫–æ–ø|–∑–æ–¥—ñ–∞–∫|—Å—Ç—Ä—ñ–ª–µ—Ü—å|–°—Ç—Ä—ñ–ª–µ—Ü—å
‚ôë	–ö–æ–∑–æ—Ä—ñ–≥	–≥–æ—Ä–æ—Å–∫–æ–ø|–∑–Ω–∞–∫ –∑–æ–¥—ñ–∞–∫—É|–∑–æ–¥—ñ–∞–∫|–∫–æ–∑–∞|–∫–æ–∑–µ—Ä—ñ–≥|–ö–æ–∑–µ—Ä—ñ–≥|–ö–æ–∑–æ—Ä—ñ–≥
‚ôí	–í–æ–¥–æ–ª—ñ–π	–≤–æ–¥–∞|–≤–æ–¥–æ–ª—ñ–π|–í–æ–¥–æ–ª—ñ–π|–≥–æ—Ä–æ—Å–∫–æ–ø|–∑–Ω–∞–∫ –∑–æ–¥—ñ–∞–∫—É –≤–æ–¥–æ–ª—ñ–π|–∑–æ–¥—ñ–∞–∫|–Ω–æ—Å—ñ–π
‚ôì	–†–∏–±–∏	–≥–æ—Ä–æ—Å–∫–æ–ø|–∑–Ω–∞–∫ –∑–æ–¥—ñ–∞–∫—É|–∑–æ–¥—ñ–∞–∫|—Ä–∏–±–∞|—Ä–∏–±–∏|–†–∏–±–∏
‚ôø	—Å–∏–º–≤–æ–ª –∫—Ä—ñ—Å–ª–∞-–≤—ñ–∑–∫–∞	–¥–æ—Å—Ç—É–ø–Ω—ñ—Å—Ç—å|—ñ–Ω–≤–∞–ª—ñ–¥–Ω–µ –∫—Ä—ñ—Å–ª–æ|—Å–∏–º–≤–æ–ª –≤—ñ–∑–∫–∞|—Å–∏–º–≤–æ–ª –∫—Ä—ñ—Å–ª–∞-–≤—ñ–∑–∫–∞
‚öì	—è–∫—ñ—Ä	–∑–Ω–∞—Ä—è–¥–¥—è|–∫–æ—Ä–∞–±–µ–ª—å|—è–∫—ñ—Ä
‚ö°	–≤–∏—Å–æ–∫–∞ –Ω–∞–ø—Ä—É–≥–∞	–±–ª–∏—Å–∫–∞–≤–∫–∞|–≤–∏—Å–æ–∫–∞ –Ω–∞–ø—Ä—É–≥–∞|–µ–ª–µ–∫—Ç—Ä–∏–∫–∞|–µ–ª–µ–∫—Ç—Ä–∏—á–Ω–∏–π|–Ω–∞–ø—Ä—É–≥–∞|–Ω–µ–±–µ–∑–ø–µ–∫–∞
‚ö™	–±—ñ–ª–∏–π –∫—Ä—É–≥	–±—ñ–ª–µ|–±—ñ–ª–∏–π –∫—Ä—É–≥|–≥–µ–æ–º–µ—Ç—Ä–∏—á–Ω–∏–π|–∫–æ–ª–æ
‚ö´	—á–æ—Ä–Ω–∏–π –∫—Ä—É–≥	–≥–µ–æ–º–µ—Ç—Ä–∏—á–Ω–∏–π|–∫–æ–ª–æ|—á–æ—Ä–Ω–µ|—á–æ—Ä–Ω–∏–π –∫—Ä—É–≥
‚öΩ	—Ñ—É—Ç–±–æ–ª—å–Ω–∏–π –º‚Äô—è—á	–º‚Äô—è—á|—Å–ø–æ—Ä—Ç|–§–Ü–§–ê|—Ñ—É—Ç–±–æ–ª|—Ñ—É—Ç–±–æ–ª—å–Ω–∏–π –º‚Äô—è—á|—á–µ–º–ø—ñ–æ–Ω–∞—Ç
‚öæ	–±–µ–π—Å–±–æ–ª—å–Ω–∏–π –º‚Äô—è—á	–±–µ–π—Å–±–æ–ª—å–Ω–∏–π –º‚Äô—è—á|–º‚Äô—è—á|—Å–ø–æ—Ä—Ç
‚õÑ	—Å–Ω—ñ–≥–æ–≤–∏–∫ –±–µ–∑ —Å–Ω—ñ–≥—É	c–Ω—ñ–≥–æ–≤–∏–∫|–ø–æ–≥–æ–¥–∞|—Å–Ω—ñ–≥|—Å–Ω—ñ–≥–æ–≤–∏–∫|—Å–Ω—ñ–≥–æ–≤–∏–∫ –±–µ–∑ —Å–Ω—ñ–≥—É|—Ö–æ–ª–æ–¥–Ω–∏–π
‚õÖ	—Å–æ–Ω—Ü–µ –∑–∞ —Ö–º–∞—Ä–æ—é	–ø–æ–≥–æ–¥–∞|—Å–æ–Ω—Ü–µ|—Å–æ–Ω—Ü–µ –∑–∞ —Ö–º–∞—Ä–æ—é|—Ö–º–∞—Ä–∞|—Ö–º–∞—Ä–Ω–æ
‚õé	–ó–º—ñ—î–Ω–æ—Å–µ—Ü—å	–≥–æ—Ä–æ—Å–∫–æ–ø|–∑–º—ñ—î–Ω–æ—Å–µ—Ü—å|–ó–º—ñ—î–Ω–æ—Å–µ—Ü—å|–∑–º—ñ—è|–∑–æ–¥—ñ–∞–∫|–Ω–æ—Å—ñ–π
‚õî	–≤ º—ó–∑–¥ –∑–∞–±–æ—Ä–æ–Ω–µ–Ω–æ	–≤‚Äô—ó–∑–¥ –∑–∞–±–æ—Ä–æ–Ω–µ–Ω–æ|–≤ º—ó–∑–¥|–∑–∞–±–æ—Ä–æ–Ω–µ–Ω–æ|–Ω–µ –≤‚Äô—ó–∂–¥–∂–∞—Ç–∏|–Ω–µ –¥–æ–∑–≤–æ–ª–µ–Ω–æ|–Ω–µ–º–∞—î|—Ä—É—Ö
‚õ™	—Ü–µ—Ä–∫–≤–∞	–±—É–¥—ñ–≤–ª—è|—Ä–µ–ª—ñ–≥—ñ—è|—Ö—Ä–µ—Å—Ç|—Ö—Ä–∏—Å—Ç–∏—è–Ω—Å—å–∫–∏–π|—Ü–µ—Ä–∫–≤–∞
‚õ≤	—Ñ–æ–Ω—Ç–∞–Ω	—Ñ–æ–Ω—Ç–∞–Ω
‚õ≥	–ª—É–Ω–∫–∞ –¥–ª—è –≥–æ–ª—å—Ñ—É –∑ –ø—Ä–∞–ø–æ—Ä—Ü–µ–º	–≥–æ–ª—å—Ñ|–≥—Ä–∞|–ª—É–Ω–∫–∞|–ª—É–Ω–∫–∞ –¥–ª—è –≥–æ–ª—å—Ñ—É –∑ –ø—Ä–∞–ø–æ—Ä—Ü–µ–º
‚õµ	–≤—ñ—Ç—Ä–∏–ª—å–Ω–∏–∫	–≤—ñ–¥–ø–æ—á–∏–Ω–æ–∫|–≤—ñ—Ç—Ä–∏–ª—å–Ω–∏–∫|–º–æ—Ä–µ|–ø–ª–∞–≤–∞–Ω–Ω—è|—Ç—Ä–∞–Ω—Å–ø–æ—Ä—Ç|—á–æ–≤–µ–Ω|—è—Ö—Ç–∞
‚õ∫	–Ω–∞–º–µ—Ç	–Ω–∞–º–µ—Ç|–ø–æ—Ö—ñ–¥
‚õΩ	–±–µ–Ω–∑–æ–∫–æ–ª–æ–Ω–∫–∞	–±–µ–Ω–∑–æ–∫–æ–ª–æ–Ω–∫–∞|–∑–∞–ø—Ä–∞–≤–∫–∞|–Ω–∞—Å–æ—Å|–ø–∞–ª–∏–≤–Ω–∏–π –Ω–∞—Å–æ—Å|–ø–∞–ª—å–Ω–µ
‚úÖ	–∫–Ω–æ–ø–∫–∞ –∑ –≥–∞–ª–æ—á–∫–æ—é	‚úì|–≤–∏–∫–æ–Ω–∞–Ω–æ|–≥–∞–ª–æ—á–∫–∞|–≥–æ—Ç–æ–≤–æ|–∑–Ω–∞—á–æ–∫|–∫–Ω–æ–ø–∫–∞|–∫–Ω–æ–ø–∫–∞ –∑ –≥–∞–ª–æ—á–∫–æ—é|–æ–ø—Ü—ñ—è|–ø–æ–∑–Ω–∞—á–∫–∞|–ø—Ä–∞–ø–æ—Ä–µ—Ü—å
‚úä	–ø—ñ–¥–Ω—è—Ç–∏–π –∫—É–ª–∞–∫	–∫—É–ª–∞–∫|–ø—ñ–¥–Ω—è—Ç–∏–π –∫—É–ª–∞–∫|—Ä—É–∫–∞|—Å—Ç–∏—Å–Ω—É—Ç–∏–π|—Ç—ñ–ª–æ
‚úã	–ø—ñ–¥–Ω—è—Ç–∞ —Ä—É–∫–∞	–¥–∞–π –ø º—è—Ç—å|–¥–æ–ª–æ–Ω—è|–ø—ñ–¥–Ω—è—Ç–∞ —Ä—É–∫–∞|—Ä—É–∫–∞|—Å—Ç–æ—è—Ç–∏|—Ç—ñ–ª–æ
‚ú®	–±–ª–∏—Å–∫—ñ—Ç–∫–∏	–±–ª–∏—Å–∫—ñ—Ç–∫–∏|–∑—ñ—Ä–∫–∞|—ñ—Å–∫—Ä–∞|—ñ—Å–∫—Ä–∏|—è—Å–∫—Ä–∞–≤–∏–π
‚ùå	—Ö—Ä–µ—Å—Ç–∏–∫	√ó|–∑–Ω–∞—á–æ–∫|–º–Ω–æ–∂–µ–Ω–Ω—è|–ø–æ–∑–Ω–∞—á–∫–∞|–ø–æ–º–Ω–æ–∂–∏—Ç–∏|—Å–∫–∞—Å—É–≤–∞—Ç–∏|—Ö|—Ö—Ä–µ—Å—Ç–∏–∫
‚ùé	–∫–Ω–æ–ø–∫–∞ –∑ —Ö—Ä–µ—Å—Ç–∏–∫–æ–º	√ó|–∑–Ω–∞—á–æ–∫|–∫–≤–∞–¥—Ä–∞—Ç|–∫–Ω–æ–ø–∫–∞ –∑ —Ö—Ä–µ—Å—Ç–∏–∫–æ–º|–ø–æ–∑–Ω–∞—á–∫–∞|—Ö
‚ùì	—á–µ—Ä–≤–æ–Ω–∏–π –∑–Ω–∞–∫ –ø–∏—Ç–∞–Ω–Ω—è	?|–∑–Ω–∞–∫ –ø–∏—Ç–∞–Ω–Ω—è|–ø–∏—Ç–∞–Ω–Ω—è|–ø—É–Ω–∫—Ç—É–∞—Ü—ñ—è|—Ä–æ–∑–¥—ñ–ª–æ–≤–∏–π –∑–Ω–∞–∫|—á–µ—Ä–≤–æ–Ω–∏–π –∑–Ω–∞–∫ –ø–∏—Ç–∞–Ω–Ω—è
‚ùî	–±—ñ–ª–∏–π –∑–Ω–∞–∫ –ø–∏—Ç–∞–Ω–Ω—è	?|–±—ñ–ª–∏–π –∑–Ω–∞–∫ –ø–∏—Ç–∞–Ω–Ω—è|–∑–Ω–∞–∫ –ø–∏—Ç–∞–Ω–Ω—è|–∫–æ–Ω—Ç—É—Ä–Ω–∏–π|–ø–∏—Ç–∞–Ω–Ω—è|–ø—É–Ω–∫—Ç—É–∞—Ü—ñ—è|—Ä–æ–∑–¥—ñ–ª–æ–≤–∏–π –∑–Ω–∞–∫
‚ùï	–±—ñ–ª–∏–π –∑–Ω–∞–∫ –æ–∫–ª–∏–∫—É	!|–±—ñ–ª–∏–π –∑–Ω–∞–∫ –æ–∫–ª–∏–∫—É|–∑–Ω–∞–∫ –æ–∫–ª–∏–∫—É|–∫–æ–Ω—Ç—É—Ä–Ω–∏–π|–æ–∫–ª–∏–∫|–ø—É–Ω–∫—Ç—É–∞—Ü—ñ—è|—Ä–æ–∑–¥—ñ–ª–æ–≤–∏–π –∑–Ω–∞–∫
‚ùó	—á–µ—Ä–≤–æ–Ω–∏–π –∑–Ω–∞–∫ –æ–∫–ª–∏–∫—É	!|–∑–Ω–∞–∫ –æ–∫–ª–∏–∫—É|–æ–∫–ª–∏–∫|–ø—É–Ω–∫—Ç—É–∞—Ü—ñ—è|—Ä–æ–∑–¥—ñ–ª–æ–≤–∏–π –∑–Ω–∞–∫|—á–µ—Ä–≤–æ–Ω–∏–π –∑–Ω–∞–∫ –æ–∫–ª–∏–∫—É
‚ûï	–ø–ª—é—Å	+|–∑–Ω–∞–∫|–º–∞—Ç–µ–º–∞—Ç–∏–∫–∞|–º–∞—Ç–µ–º–∞—Ç–∏—á–Ω–∏–π|–ø–ª—é—Å
‚ûñ	–º—ñ–Ω—É—Å	-|‚àí|–∑–Ω–∞–∫|–º–∞—Ç–µ–º–∞—Ç–∏–∫–∞|–º–∞—Ç–µ–º–∞—Ç–∏—á–Ω–∏–π|–º—ñ–Ω—É—Å
‚ûó	–¥—ñ–ª–µ–Ω–Ω—è	√∑|–¥—ñ–ª–µ–Ω–Ω—è|–∑–Ω–∞–∫|–º–∞—Ç–µ–º–∞—Ç–∏–∫–∞|–º–∞—Ç–µ–º–∞—Ç–∏—á–Ω–∏–π
‚û∞	–∑–∞–∫—Ä—É—á–µ–Ω–∞ –ø–µ—Ç–ª—è	–∑–∞–∫—Ä—É—á–µ–Ω–∞ –ø–µ—Ç–ª—è|–∑–∞–∫—Ä—É—á–µ–Ω–∏–π|–ø–µ—Ç–ª—è
‚ûø	–ø–æ–¥–≤—ñ–π–Ω–∞ –∑–∞–∫—Ä—É—á–µ–Ω–∞ –ø–µ—Ç–ª—è	–∑–∞–∫—Ä—É—á–µ–Ω–∏–π|–ø–µ—Ç–ª—è|–ø–æ–¥–≤—ñ–π–Ω–∞ –∑–∞–∫—Ä—É—á–µ–Ω–∞ –ø–µ—Ç–ª—è|–ø–æ–¥–≤—ñ–π–Ω–∏–π
‚¨õ	–≤–µ–ª–∏–∫–∏–π —á–æ—Ä–Ω–∏–π –∫–≤–∞–¥—Ä–∞—Ç	–≤–µ–ª–∏–∫–∏–π —á–æ—Ä–Ω–∏–π –∫–≤–∞–¥—Ä–∞—Ç|–≥–µ–æ–º–µ—Ç—Ä–∏—á–Ω–∏–π|–∫–≤–∞–¥—Ä–∞—Ç
‚¨ú	–≤–µ–ª–∏–∫–∏–π –±—ñ–ª–∏–π –∫–≤–∞–¥—Ä–∞—Ç	–≤–µ–ª–∏–∫–∏–π –±—ñ–ª–∏–π –∫–≤–∞–¥—Ä–∞—Ç|–≥–µ–æ–º–µ—Ç—Ä–∏—á–Ω–∏–π|–∫–≤–∞–¥—Ä–∞—Ç
‚≠ê	–∑—ñ—Ä–∫–∞	–∑—ñ—Ä–∫–∞|—Å–µ—Ä–µ–¥–Ω—è –±—ñ–ª–∞ –∑—ñ—Ä–∫–∞
‚≠ï	–ø–æ—Ä–æ–∂–Ω–∏—Å—Ç–µ —á–µ—Ä–≤–æ–Ω–µ –∫–æ–ª–æ	–≤–µ–ª–∏–∫–µ|–∫–æ–ª–æ|–æ|–ø–æ—Ä–æ–∂–Ω–∏—Å—Ç–µ —á–µ—Ä–≤–æ–Ω–µ –∫–æ–ª–æ|—á–µ—Ä–≤–æ–Ω–µ
üÄÑ	—Ñ—ñ—à–∫–∞ –º–∞–¥–∂–æ–Ω–≥—É ¬´—á–µ—Ä–≤–æ–Ω–∏–π –¥—Ä–∞–∫–æ–Ω¬ª	–≥—Ä–∞|–º–∞–¥–∂–æ–Ω–≥|—Ñ—ñ—à–∫–∞ –º–∞–¥–∂–æ–Ω–≥ —á–µ—Ä–≤–æ–Ω–∏–π –¥—Ä–∞–∫–æ–Ω|—Ñ—ñ—à–∫–∞ –º–∞–¥–∂–æ–Ω–≥—É ¬´—á–µ—Ä–≤–æ–Ω–∏–π –¥—Ä–∞–∫–æ–Ω¬ª|—á–µ—Ä–≤–æ–Ω–∏–π
üÉè	–¥–∂–æ–∫–µ—Ä	–≥—Ä–∞|–≥—Ä–∞—Ç–∏|–¥–∂–æ–∫–µ—Ä|–∫–∞—Ä—Ç–∞
üÜé	–∫–Ω–æ–ø–∫–∞ AB (IV –≥—Ä—É–ø–∞ –∫—Ä–æ–≤—ñ)	3|ab|iii|–≥—Ä—É–ø–∞ –∫—Ä–æ–≤—ñ|–≥—Ä—É–ø–∞ –∫—Ä–æ–≤—ñ AB|–∫–Ω–æ–ø–∫–∞ ¬´–≥—Ä—É–ø–∞ –∫—Ä–æ–≤—ñ ab¬ª|–∫–Ω–æ–ø–∫–∞ AB (IV –≥—Ä—É–ø–∞ –∫—Ä–æ–≤—ñ)|–∫—Ä–æ–≤|—á–µ—Ç–≤–µ—Ä—Ç–∞ –≥—Ä—É–ø–∞ –∫—Ä–æ–≤—ñ
üÜë	–∫–Ω–æ–ø–∫–∞ ¬´–æ—á–∏—Å—Ç–∏—Ç–∏¬ª	–∫–≤–∞–¥—Ä–∞—Ç ¬´–æ—á–∏—Å—Ç–∏—Ç–∏ —Ç–µ–∫—Å—Ç¬ª|–∫–ª–∞–≤—ñ—à–∞ "–æ—á–∏—Å—Ç–∏—Ç–∏ —Ç–µ–∫—Å—Ç"|–∫–Ω–æ–ø–∫–∞ ¬´–æ—á–∏—Å—Ç–∏—Ç–∏¬ª|–æ—á–∏—Å—Ç–∏—Ç–∏ —Ç–µ–∫—Å—Ç
üÜí	–∫–Ω–æ–ø–∫–∞ ¬´COOL¬ª	–∫–≤–∞–¥—Ä–∞—Ç ¬´–∫—Ä—É—Ç–æ¬ª|–∫–Ω–æ–ø–∫–∞ ¬´COOL¬ª|–∫—Ä—É—Ç–æ
üÜì	–∫–Ω–æ–ø–∫–∞ ¬´FREE¬ª	FREE|–±–µ–∑–∫–æ—à—Ç–æ–≤–Ω–æ|–±–µ–∑–ø–ª–∞—Ç–Ω–æ|–∫–≤–∞–¥—Ä–∞—Ç ¬´–±–µ–∑–∫–æ—à—Ç–æ–≤–Ω–æ¬ª|–∫–Ω–æ–ø–∫–∞ ¬´FREE¬ª
üÜî	–∫–Ω–æ–ø–∫–∞ "ID"	—ñ–¥–µ–Ω—Ç–∏—Ñ—ñ–∫–∞—Ç–æ—Ä|—ñ–¥–µ–Ω—Ç–∏—Ñ—ñ–∫–∞—Ü—ñ—è|–∫–≤–∞–¥—Ä–∞—Ç ¬´—ñ–¥–µ–Ω—Ç–∏—Ñ—ñ–∫–∞—Ç–æ—Ä¬ª|–∫–Ω–æ–ø–∫–∞ "ID"|–∫–Ω–æ–ø–∫–∞ —ñ–¥–µ–Ω—Ç–∏—Ñ—ñ–∫–∞—Ü—ñ—ó|–æ—Å–æ–±–∏—Å—Ç—ñ—Å—Ç—å
üÜï	–∫–Ω–æ–ø–∫–∞ "NEW"	–∫–≤–∞–¥—Ä–∞—Ç ¬´–Ω–æ–≤–∏–π¬ª|–∫–Ω–æ–ø–∫–∞ "NEW"|–Ω–æ–≤–∏–π
üÜñ	–∫–Ω–æ–ø–∫–∞ "NG"	–∞–±—Å–æ–ª—é—Ç–Ω–æ –Ω—ñ|–∫–≤–∞–¥—Ä–∞—Ç ¬´–Ω–µ–≥–∞—Ç–∏–≤–Ω–æ¬ª|–∫–Ω–æ–ø–∫–∞ "NG"|–Ω–µ–≥–∞—Ç–∏–≤–Ω–æ
üÜó	–∫–Ω–æ–ø–∫–∞ ¬´–û–ö¬ª	OK|–û–ö|–æ–∫–µ–π
üÜò	–∫–Ω–æ–ø–∫–∞ "SOS"	sos|–¥–æ–ø–æ–º–æ–≥–∞|–∫–≤–∞–¥—Ä–∞—Ç ¬´sos¬ª|–∫–Ω–æ–ø–∫–∞ "SOS"
üÜô	–∫–Ω–æ–ø–∫–∞ "UP!"	–≤–≥–æ—Ä—É|–∑–Ω–∞—á–æ–∫|–∫–Ω–æ–ø–∫–∞ "UP!"|–∫–Ω–æ–ø–∫–∞ ¬´–≤–≥–æ—Ä—É!¬ª
üÜö	–∫–Ω–æ–ø–∫–∞ "VS"	–∫–≤–∞–¥—Ä–∞—Ç ¬´–ø—Ä–æ—Ç–∏¬ª|–∫–Ω–æ–ø–∫–∞ "VS"|–ø—Ä–æ—Ç–∏
üàÅ	–∫–Ω–æ–ø–∫–∞ "—Ç—É—Ç" —è–ø–æ–Ω—Å—å–∫–æ—é	—ñ—î—Ä–æ–≥–ª—ñ—Ñ|–∫–≤–∞–¥—Ä–∞—Ç –∑ —ñ–¥–µ–æ–≥—Ä–∞–º–æ—é ¬´—Ç—É—Ç¬ª|–∫–Ω–æ–ø–∫–∞ "—Ç—É—Ç" —è–ø–æ–Ω—Å—å–∫–æ—é|—è–ø–æ–Ω—Å—å–∫–∏–π
üàö	–∫–Ω–æ–ø–∫–∞ "–±–µ–∑–∫–æ—à—Ç–æ–≤–Ω–æ" —è–ø–æ–Ω—Å—å–∫–æ—é	—ñ—î—Ä–æ–≥–ª—ñ—Ñ|–∫–≤–∞–¥—Ä–∞—Ç –∑ —ñ–¥–µ–æ–≥—Ä–∞–º–æ—é ¬´–∑–∞–ø–µ—Ä–µ—á–µ–Ω–Ω—è¬ª|–∫–Ω–æ–ø–∫–∞ "–±–µ–∑–∫–æ—à—Ç–æ–≤–Ω–æ" —è–ø–æ–Ω—Å—å–∫–æ—é|—è–ø–æ–Ω—Å—å–∫–∏–π
üàØ	–∫–Ω–æ–ø–∫–∞ "–∑–∞—Ä–µ–∑–µ—Ä–≤–æ–≤–∞–Ω–æ" —è–ø–æ–Ω—Å—å–∫–æ—é	—ñ—î—Ä–æ–≥–ª—ñ—Ñ|–∫–Ω–æ–ø–∫–∞ "–∑–∞—Ä–µ–∑–µ—Ä–≤–æ–≤–∞–Ω–æ" —è–ø–æ–Ω—Å—å–∫–æ—é|—è–ø–æ–Ω—Å—å–∫–∏–π
üà≤	–∫–Ω–æ–ø–∫–∞ "–∑–∞–±–æ—Ä–æ–Ω–µ–Ω–æ" —è–ø–æ–Ω—Å—å–∫–æ—é	—ñ—î—Ä–æ–≥–ª—ñ—Ñ|–∫–≤–∞–¥—Ä–∞—Ç –∑ —ñ–¥–µ–æ–≥—Ä–∞–º–æ—é ¬´–∑–∞–±–æ—Ä–æ–Ω–µ–Ω–æ¬ª|–∫–Ω–æ–ø–∫–∞ "–∑–∞–±–æ—Ä–æ–Ω–µ–Ω–æ" —è–ø–æ–Ω—Å—å–∫–æ—é|—è–ø–æ–Ω—Å—å–∫–∏–π
üà≥	–∫–Ω–æ–ø–∫–∞ "–≤—ñ–ª—å–Ω–æ" —è–ø–æ–Ω—Å—å–∫–æ—é	—ñ–¥–µ–æ–≥—Ä–∞–º–∞|—ñ—î—Ä–æ–≥–ª—ñ—Ñ|–∫–∏—Ç–∞–π—Å—å–∫–∏–π|–∫–Ω–æ–ø–∫–∞ "–≤—ñ–ª—å–Ω–æ" —è–ø–æ–Ω—Å—å–∫–æ—é|–ø—É—Å—Ç–æ—Ç–∞|—è–ø–æ–Ω—Å—å–∫–∏–π
üà¥	–∫–Ω–æ–ø–∫–∞ "–¥–æ—Å—Ç–∞—Ç–Ω—è –æ—Ü—ñ–Ω–∫–∞" —è–ø–æ–Ω—Å—å–∫–æ—é	—ñ—î—Ä–æ–≥–ª—ñ—Ñ|–∫–∏—Ç–∞–π—Å—å–∫–∏–π|–∫–Ω–æ–ø–∫–∞ "–¥–æ—Å—Ç–∞—Ç–Ω—è –æ—Ü—ñ–Ω–∫–∞" —è–ø–æ–Ω—Å—å–∫–æ—é|–Ø–ø–æ–Ω—ñ—è|–Ø–ø–æ–Ω—Å—å–∫–∏–π
üàµ	–∫–Ω–æ–ø–∫–∞ "–º—ñ—Å—Ü—å –Ω–µ–º–∞—î" —è–ø–æ–Ω—Å—å–∫–æ—é	–∫–≤–∞–¥—Ä–∞—Ç –∑ —ñ–¥–µ–æ–≥—Ä–∞–º–æ—é ¬´–∑–∞–ø–æ–≤–Ω–µ–Ω—ñ—Å—Ç—å¬ª|–∫–∏—Ç–∞–π—Å—å–∫–∏–π|–∫–Ω–æ–ø–∫–∞ "–º—ñ—Å—Ü—å –Ω–µ–º–∞—î" —è–ø–æ–Ω—Å—å–∫–æ—é|—è–ø–æ–Ω—Å—å–∫–∏–π —ñ—î—Ä–æ–≥–ª—ñ—Ñ
üà∂	–∫–Ω–æ–ø–∫–∞ "–Ω–µ –±–µ–∑–∫–æ—à—Ç–æ–≤–Ω–æ" —è–ø–æ–Ω—Å—å–∫–æ—é	—ñ—î—Ä–æ–≥–ª—ñ—Ñ|–∫–≤–∞–¥—Ä–∞—Ç –∑ —ñ–¥–µ–æ–≥—Ä–∞–º–æ—é ¬´—ñ—Å–Ω—É—î¬ª|–∫–Ω–æ–ø–∫–∞ "–Ω–µ –±–µ–∑–∫–æ—à—Ç–æ–≤–Ω–æ" —è–ø–æ–Ω—Å—å–∫–æ—é|—è–ø–æ–Ω—Å—å–∫–∏–π
üà∏	–∫–Ω–æ–ø–∫–∞ "–∑–∞—è–≤–∫–∞" —è–ø–æ–Ω—Å—å–∫–æ—é	—ñ—î—Ä–æ–≥–ª—ñ—Ñ|–∫–≤–∞–¥—Ä–∞—Ç –∑ —ñ–¥–µ–æ–≥—Ä–∞–º–æ—é ¬´–ø–æ–¥–∞—Ç–∏ –∑–∞—è–≤–∫—É¬ª|–∫–∏—Ç–∞–π—Å—å–∫–∏–π|–∫–Ω–æ–ø–∫–∞ "–∑–∞—è–≤–∫–∞" —è–ø–æ–Ω—Å—å–∫–æ—é
üàπ	–∫–Ω–æ–ø–∫–∞ "–∑–Ω–∏–∂–∫–∞" —è–ø–æ–Ω—Å—å–∫–æ—é	—ñ—î—Ä–æ–≥–ª—ñ—Ñ|–∫–≤–∞–¥—Ä–∞—Ç –∑ —ñ–¥–µ–æ–≥—Ä–∞–º–æ—é ¬´–ø–æ–¥—ñ–ª–∏—Ç–∏¬ª|–∫–Ω–æ–ø–∫–∞ "–∑–Ω–∏–∂–∫–∞" —è–ø–æ–Ω—Å—å–∫–æ—é|—è–ø–æ–Ω—Å—å–∫–∏–π
üà∫	–∫–Ω–æ–ø–∫–∞ "—Ä–æ–±–æ—Ç–∞" —è–ø–æ–Ω—Å—å–∫–æ—é	—ñ—î—Ä–æ–≥–ª—ñ—Ñ|–∫–≤–∞–¥—Ä–∞—Ç –∑ —ñ–¥–µ–æ–≥—Ä–∞–º–æ—é ¬´—Ä–æ–±–æ—Ç–∞¬ª|–∫–∏—Ç–∞–π—Å—å–∫–∏–π|–∫–Ω–æ–ø–∫–∞ "—Ä–æ–±–æ—Ç–∞" —è–ø–æ–Ω—Å—å–∫–æ—é
üâê	–∫–Ω–æ–ø–∫–∞ "—É–≥–æ–¥–∞" —è–ø–æ–Ω—Å—å–∫–æ—é	—ñ—î—Ä–æ–≥–ª—ñ—Ñ|–∫–Ω–æ–ø–∫–∞ "—É–≥–æ–¥–∞" —è–ø–æ–Ω—Å—å–∫–æ—é|–Ø–ø–æ–Ω—ñ—è|—è–ø–æ–Ω—Å—å–∫–∏–π
üâë	–∫–Ω–æ–ø–∫–∞ "–ø—Ä–∏–π–Ω—è—Ç–Ω–æ" —è–ø–æ–Ω—Å—å–∫–æ—é	—ñ—î—Ä–æ–≥–ª—ñ—Ñ|–∫–∏—Ç–∞–π—Å—å–∫–∏–π|–∫–Ω–æ–ø–∫–∞ "–ø—Ä–∏–π–Ω—è—Ç–Ω–æ" —è–ø–æ–Ω—Å—å–∫–æ—é|–∫–æ–ª–æ –∑ —ñ–¥–µ–æ–≥—Ä–∞–º–æ—é ¬´–ø—Ä–∏–π–Ω—è—Ç–∏¬ª
üåÄ	—Ü–∏–∫–ª–æ–Ω	–∑–∞–ø–∞–º–æ—Ä–æ—á–µ–Ω–Ω—è|–ø–æ–≥–æ–¥–∞|—Å–º–µ—Ä—á|—Å–ø—ñ—Ä–∞–ª—å|—Ç–∞–π—Ñ—É–Ω|—Ü–∏–∫–ª–æ–Ω
üåÅ	—Ç—É–º–∞–Ω–Ω–æ	–≤–µ—Ä—Ö—ñ–≤–∫–∞|–≥–æ—Ä–∞|–ø–æ–≥–æ–¥–∞|—Ç–æ–ø|—Ç—É–º–∞–Ω|—Ç—É–º–∞–Ω–Ω–æ
üåÇ	—Å–∫–ª–∞–¥–µ–Ω–∞ –ø–∞—Ä–∞—Å–æ–ª—å–∫–∞	–¥–æ—â|–æ–¥—è–≥|–ø–∞—Ä–∞—Å–æ–ª—å–∫–∞|–ø–æ–≥–æ–¥–∞|—Å–∫–ª–∞–¥–µ–Ω–∞ –ø–∞—Ä–∞—Å–æ–ª—å–∫–∞
üåÉ	–∑–æ—Ä—è–Ω–∞ –Ω—ñ—á	–∑—ñ—Ä–∫–∞|–∑–æ—Ä—è–Ω–∞ –Ω—ñ—á|–Ω—ñ—á|–ø–æ–≥–æ–¥–∞
üåÑ	—Å—Ö—ñ–¥ —Å–æ–Ω—Ü—è –Ω–∞–¥ –≥–æ—Ä–∞–º–∏	–≥–æ—Ä–∞|–ø–æ–≥–æ–¥–∞|—Ä–∞–Ω–æ–∫|—Å–æ–Ω—Ü–µ|—Å—Ö—ñ–¥|—Å—Ö—ñ–¥ —Å–æ–Ω—Ü—è –Ω–∞–¥ –≥–æ—Ä–∞–º–∏
üåÖ	—Å—Ö—ñ–¥ —Å–æ–Ω—Ü—è	–ø–æ–≥–æ–¥–∞|—Ä–∞–Ω–æ–∫|—Å–≤—ñ—Ç–∞–Ω–æ–∫|—Å–æ–Ω—Ü–µ|—Å—Ö—ñ–¥ —Å–æ–Ω—Ü—è
üåÜ	–º—ñ—Å—Ç–æ –≤ —Å—É—Ç—ñ–Ω–∫–∞—Ö	–±—É–¥—ñ–≤–ª—è|–≤–µ—á—ñ—Ä|–∑–∞—Ö—ñ–¥|–ª–∞–Ω–¥—à–∞—Ñ—Ç|–º—ñ—Å—Ç–æ|–º—ñ—Å—Ç–æ –≤ —Å—É—Ç—ñ–Ω–∫–∞—Ö|—Å—É—Ç—ñ–Ω–∫–∏
üåá	–∑–∞—Ö—ñ–¥ —Å–æ–Ω—Ü—è	–±—É–¥—ñ–≤–ª—è|–∑–∞—Ö—ñ–¥ —Å–æ–Ω—Ü—è|–º—ñ—Å—Ç–æ|—Å–æ–Ω—Ü–µ|—Å—É—Ç—ñ–Ω–∫–∏
üåà	–≤–µ—Å–µ–ª–∫–∞	–±—ñ—Å–µ–∫—Å—É–∞–ª|–≥–µ–π|–≥–µ–Ω–¥–µ—Ä|–≥–ª–±—Ç|–¥–æ—â|–∫–≤—ñ—Ä|–ª–≥–±—Ç|–ª–µ—Å–±—ñ—è–Ω–∫–∞|–ø–æ–≥–æ–¥–∞|–ø—Ä–∏—Ä–æ–¥–∞|—Ç—Ä–∞–Ω—Å
üåâ	–º—ñ—Å—Ç —É–Ω–æ—á—ñ	golden gate|–º—ñ—Å—Ç|–º—ñ—Å—Ç —É–Ω–æ—á—ñ|–Ω—ñ—á|–ø–æ–≥–æ–¥–∞
üåä	—Ö–≤–∏–ª—è	–≤–æ–¥–∞|–æ–∫–µ–∞–Ω|–ø–æ–≥–æ–¥–∞|—Ö–≤–∏–ª—è
üåã	–≤—É–ª–∫–∞–Ω	–≤–∏–≤–µ—Ä–∂–µ–Ω–Ω—è|–≤—É–ª–∫–∞–Ω|–≥–æ—Ä–∞|–ª–∞–≤–∞
üåå	–ß—É–º–∞—Ü—å–∫–∏–π —à–ª—è—Ö	–∫–æ—Å–º–æ—Å|–ø–æ–≥–æ–¥–∞|—á—É–º–∞—Ü—å–∫–∏–π —à–ª—è—Ö|–ß—É–º–∞—Ü—å–∫–∏–π —à–ª—è—Ö
üåç	–≥–ª–æ–±—É—Å, —â–æ –ø–æ–∫–∞–∑—É—î –Ñ–≤—Ä–æ–ø—É –π –ê—Ñ—Ä–∏–∫—É	–∞—Ñ—Ä–∏–∫–∞|–ê—Ñ—Ä–∏–∫–∞|–≥–ª–æ–±—É—Å|–≥–ª–æ–±—É—Å, —â–æ –ø–æ–∫–∞–∑—É—î –Ñ–≤—Ä–æ–ø—É –π –ê—Ñ—Ä–∏–∫—É|—î–≤—Ä–æ–ø–∞|–Ñ–≤—Ä–æ–ø–∞|–∑–µ–º–ª—è|—Å–≤—ñ—Ç|—â–æ –ø–æ–∫–∞–∑—É—î –Ñ–≤—Ä–æ–ø—É –π –ê—Ñ—Ä–∏–∫—É
üåé	–≥–ª–æ–±—É—Å, —â–æ –ø–æ–∫–∞–∑—É—î –ê–º–µ—Ä–∏–∫–∏	–ê–º–µ—Ä–∏–∫–∞|–≥–ª–æ–±—É—Å|–≥–ª–æ–±—É—Å, —â–æ –ø–æ–∫–∞–∑—É—î –ê–º–µ—Ä–∏–∫–∏|–ó–∞—Ö—ñ–¥–Ω–∞ –ø—ñ–≤–∫—É–ª—è|–∑–µ–º–ª—è|–ø–ª–∞–Ω–µ—Ç–∞|—Å–≤—ñ—Ç|—â–æ –ø–æ–∫–∞–∑—É—î –ê–º–µ—Ä–∏–∫–∏
üåè	–≥–ª–æ–±—É—Å, —â–æ –ø–æ–∫–∞–∑—É—î –ê–∑—ñ—é —ñ –ê–≤—Å—Ç—Ä–∞–ª—ñ—é	–∞–≤—Å—Ç—Ä–∞–ª—ñ—è|–ê–≤—Å—Ç—Ä–∞–ª—ñ—è|–∞–∑—ñ—è|–ê–∑—ñ—è|–≥–ª–æ–±—É—Å|–≥–ª–æ–±—É—Å, —â–æ –ø–æ–∫–∞–∑—É—î –ê–∑—ñ—é —ñ –ê–≤—Å—Ç—Ä–∞–ª—ñ—é|–∑–µ–º–ª—è|—Å–≤—ñ—Ç|—â–æ –ø–æ–∫–∞–∑—É—î –ê–∑—ñ—é —ñ –ê–≤—Å—Ç—Ä–∞–ª—ñ—é
üåê	–∑–µ–º–Ω–∞ –∫—É–ª—è –∑ –º–µ—Ä–∏–¥—ñ–∞–Ω–∞–º–∏	–≥–ª–æ–±—É—Å|–≥–ª–æ–±—É—Å —ñ–∑ –º–µ—Ä–∏–¥—ñ–∞–Ω–∞–º–∏|–∑–µ–º–ª—è|–∑–µ–º–Ω–∞ –∫—É–ª—è –∑ –º–µ—Ä–∏–¥—ñ–∞–Ω–∞–º–∏|–º–µ—Ä–∏–¥—ñ–∞–Ω–∏|—Å–≤—ñ—Ç
üåë	–º–æ–ª–æ–¥–∏–π –º—ñ—Å—è—Ü—å	–∫–æ—Å–º–æ—Å|–º—ñ—Å—è—Ü—å|–º–æ–ª–æ–¥–∏–π|–ø–æ–≥–æ–¥–∞|—Ç–µ–º–Ω–∏–π
üåí	–º—ñ—Å—è—Ü—å —É –ø–µ—Ä—à—ñ–π —á–≤–µ—Ä—Ç—ñ	–∑—Ä–æ—Å—Ç–∞—é—á–∏–π|–∫–æ—Å–º–æ—Å|–º—ñ—Å—è—Ü—å|–º—ñ—Å—è—Ü—å —É –ø–µ—Ä—à—ñ–π —á–≤–µ—Ä—Ç—ñ|–º–æ–ª–æ–¥–∏–π –ø—ñ–≤–º—ñ—Å—è—Ü—å|–ø—ñ–≤–º—ñ—Å—è—Ü—å|–ø–æ–≥–æ–¥–∞
üåì	–ø–µ—Ä—à–∞ —á–≤–µ—Ä—Ç—å –º—ñ—Å—è—Ü—è	–∫–æ—Å–º–æ—Å|–ª—É–Ω–∞|–º—ñ—Å—è—Ü—å|–º—ñ—Å—è—Ü—å —É –ø–µ—Ä—à—ñ–π —á–≤–µ—Ä—Ç—ñ|–ø–µ—Ä—à–∞ —á–≤–µ—Ä—Ç—å –º—ñ—Å—è—Ü—è|–ø–æ–≥–æ–¥–∞|—á–≤–µ—Ä—Ç—å
üåî	–º—ñ—Å—è—Ü—å —É –¥—Ä—É–≥—ñ–π —á–≤–µ—Ä—Ç—ñ	–∑—Ä–æ—Å—Ç–∞—é—á–∏–π|–∫–æ—Å–º–æ—Å|–º—ñ—Å—è—Ü—å|–º—ñ—Å—è—Ü—å —É –¥—Ä—É–≥—ñ–π —á–≤–µ—Ä—Ç—ñ|–ø–æ–≥–æ–¥–∞|—Å–µ—Ä–ø–æ–ø–æ–¥—ñ–±–Ω–∏–π
üåï	–ø–æ–≤–Ω–∏–π –º—ñ—Å—è—Ü—å	–∫–æ—Å–º–æ—Å|–º—ñ—Å—è—Ü—å|–ø–æ–≤–Ω–∏–π|–ø–æ–≥–æ–¥–∞
üåñ	–º—ñ—Å—è—Ü—å —É —Ç—Ä–µ—Ç—ñ–π —á–≤–µ—Ä—Ç—ñ	–∫–æ—Å–º–æ—Å|–º—ñ—Å—è—Ü—å|–º—ñ—Å—è—Ü—å —É —Ç—Ä–µ—Ç—ñ–π —á–≤–µ—Ä—Ç—ñ|–ø–æ–≥–æ–¥–∞|—Å–µ—Ä–ø–æ–ø–æ–¥—ñ–±–Ω–∏–π|—Å–ø–∞–¥–∞—é—á–∏–π
üåó	–æ—Å—Ç–∞–Ω–Ω—è —á–≤–µ—Ä—Ç—å –º—ñ—Å—è—Ü—è	–∑–∞—Ç–µ–º–Ω–µ–Ω–Ω—è|–∫–æ—Å–º–æ—Å|–º—ñ—Å—è—Ü—å|–º—ñ—Å—è—Ü—å –≤ –æ—Å—Ç–∞–Ω–Ω—ñ–π —á–≤–µ—Ä—Ç—ñ|–Ω–µ–±–æ|–æ—Å—Ç–∞–Ω–Ω—è —á–≤–µ—Ä—Ç—å –º—ñ—Å—è—Ü—è|–ø–ª–∞–Ω–µ—Ç–∞|–ø–æ–≥–æ–¥–∞|—Å—É–ø—É—Ç–Ω–∏–∫|—á–≤–µ—Ä—Ç—å
üåò	–º—ñ—Å—è—Ü—å —É —á–µ—Ç–≤–µ—Ä—Ç—ñ–π —á–≤–µ—Ä—Ç—ñ	–∫–æ—Å–º–æ—Å|–º—ñ—Å—è—Ü—å|–º—ñ—Å—è—Ü—å —É —á–µ—Ç–≤–µ—Ä—Ç—ñ–π —á–≤–µ—Ä—Ç—ñ|–ø—ñ–≤–º—ñ—Å—è—Ü—å|–ø–æ–≥–æ–¥–∞|—Å–ø–∞–¥–∞—é—á–∏–π|—Å—Ç–∞—Ä–∏–π –º—ñ—Å—è—Ü—å
üåô	—Å–µ—Ä–ø –º—ñ—Å—è—Ü—è	–∫–æ—Å–º–æ—Å|–º—ñ—Å—è—Ü—å|–ø—ñ–≤–º—ñ—Å—è—Ü—å|–ø–æ–≥–æ–¥–∞|—Å–µ—Ä–ø –º—ñ—Å—è—Ü—è
üåö	–º–æ–ª–æ–¥–∏–π –º—ñ—Å—è—Ü—å –∑ –æ–±–ª–∏—á—á—è–º	–∫–æ—Å–º–æ—Å|–º—ñ—Å—è—Ü—å|–º–æ–ª–æ–¥–∏–π –º—ñ—Å—è—Ü—å –∑ –æ–±–ª–∏—á—á—è–º|–æ–±–ª–∏—á—á—è|–ø–æ–≥–æ–¥–∞
üåõ	–ø–µ—Ä—à–∞ —á–≤–µ—Ä—Ç—å –º—ñ—Å—è—Ü—è –∑ –æ–±–ª–∏—á—á—è–º	–∫–æ—Å–º–æ—Å|–º—ñ—Å—è—Ü—å|–æ–±–ª–∏—á—á—è|–ø–µ—Ä—à–∞ —á–≤–µ—Ä—Ç—å –º—ñ—Å—è—Ü—è –∑ –æ–±–ª–∏—á—á—è–º|–ø–æ–≥–æ–¥–∞|—á–≤–µ—Ä—Ç—å
üåú	–æ—Å—Ç–∞–Ω–Ω—è —á–≤–µ—Ä—Ç—å –º—ñ—Å—è—Ü—è –∑ –æ–±–ª–∏—á—á—è–º	–∫–æ—Å–º–æ—Å|–º—ñ—Å—è—Ü—å|–æ–±–ª–∏—á—á—è|–æ—Å—Ç–∞–Ω–Ω—è —á–≤–µ—Ä—Ç—å –º—ñ—Å—è—Ü—è –∑ –æ–±–ª–∏—á—á—è–º|–ø–æ–≥–æ–¥–∞|—á–≤–µ—Ä—Ç—å
üåù	–ø–æ–≤–Ω–∏–π –º—ñ—Å—è—Ü—å –∑ –æ–±–ª–∏—á—á—è–º	–º—ñ—Å—è—Ü—å|–æ–±–ª–∏—á—á—è|–ø–æ–≤–Ω–∏–π|–ø–æ–≤–Ω–∏–π –º—ñ—Å—è—Ü—å –∑ –æ–±–ª–∏—á—á—è–º|—è—Å–∫—Ä–∞–≤–∏–π
üåû	—Å–æ–Ω—Ü–µ –∑ –æ–±–ª–∏—á—á—è–º	–≤–µ—Å–Ω–∞|–∫–æ—Å–º–æ—Å|–ª—ñ—Ç–æ|–æ–±–ª–∏—á—á—è|–ø–æ–≥–æ–¥–∞|—Å–æ–Ω—Ü–µ|—Å–æ–Ω—Ü–µ –∑ –æ–±–ª–∏—á—á—è–º|—è—Å–∫—Ä–∞–≤–∏–π
üåü	—Å—è–π–Ω–∞ –∑—ñ—Ä–∫–∞	–±–ª–∏—Å–∫—É—á–∏–π|–∑—ñ—Ä–∫–∞|—ñ—Å–∫—Ä–∞|—Å–≤—ñ—Ç–∏—Ç—å—Å—è|—Å–≤—ñ—Ç–ª–æ|—Å—è—î|—Å—è–π–Ω–∞ –∑—ñ—Ä–∫–∞
üå†	–º–µ—Ç–µ–æ—Ä	–∑—ñ—Ä–∫–∞|–∫–æ—Å–º–æ—Å|–º–µ—Ç–µ–æ—Ä|–Ω–µ–±–æ|–ø–∞–¥–∞—î
üå≠	—Ö–æ—Ç-–¥–æ–≥	—ó–∂–∞|—Å–æ—Å–∏—Å–∫–∞|—Å–æ—Å–∏—Å–∫–∞ –≤ —Ç—ñ—Å—Ç—ñ|—Ö–æ—Ç-–¥–æ–≥
üåÆ	—Ç–∞–∫–æ	—ó–∂–∞|–º–µ–∫—Å–∏–∫–∞|–ú–µ–∫—Å–∏–∫–∞|–º–µ–∫—Å–∏–∫–∞–Ω—Å—å–∫–∞ —ó–∂–∞|–º–µ–∫—Å–∏–∫–∞–Ω—Å—å–∫–∞ –∫—É—Ö–Ω—è|—Ç–∞–∫–æ|—Ç–∞–∫–æ—Å
üåØ	–±—É—Ä—ñ—Ç–æ	–±—É—Ä—ñ—Ç–æ|—ó–∂–∞|–º–µ–∫—Å–∏–∫–∞|–ú–µ–∫—Å–∏–∫–∞
üå∞	–∫–∞—à—Ç–∞–Ω	–≥–æ—Ä—ñ—Ö|–∫–∞—à—Ç–∞–Ω|—Ä–æ—Å–ª–∏–Ω–∞
üå±	—Å—ñ—è–Ω–µ—Ü—å	–ª–∏—Å—Ç—è|–ø–∞—Ä–æ—Å—Ç–æ–∫|—Ä–æ—Å–ª–∏–Ω–∞|—Å–∞–¥–∂–∞–Ω–µ—Ü—å|—Å—ñ—è–Ω–µ—Ü—å
üå≤	–≤—ñ—á–Ω–æ–∑–µ–ª–µ–Ω–µ –¥–µ—Ä–µ–≤–æ	–≤—ñ—á–Ω–æ–∑–µ–ª–µ–Ω–∞ —Ä–æ—Å–ª–∏–Ω–∞|–≤—ñ—á–Ω–æ–∑–µ–ª–µ–Ω–µ –¥–µ—Ä–µ–≤–æ|–¥–µ—Ä–µ–≤–æ|—Ä–æ—Å–ª–∏–Ω–∞|—Å–æ—Å–Ω–∞|—è–ª–∏–Ω–∫–∞
üå≥	–ª–∏—Å—Ç—è–Ω–µ –¥–µ—Ä–µ–≤–æ	–¥–µ—Ä–µ–≤–æ|–ª–∏—Å—Ç—è–Ω–µ –¥–µ—Ä–µ–≤–æ|–ª–∏—Å—Ç—è–Ω–∏–π|–æ–ø–∞–¥–∞—î|—Ä–æ—Å–ª–∏–Ω–∞
üå¥	–ø–∞–ª—å–º–∞	–¥–µ—Ä–µ–≤–æ|–ø–∞–ª—å–º–∞|—Ä–æ—Å–ª–∏–Ω–∞|—Ç—Ä–æ–ø—ñ–∫–∏
üåµ	–∫–∞–∫—Ç—É—Å	–∫–∞–∫—Ç—É—Å|–ø—É—Å—Ç–µ–ª—è|—Ä–æ—Å–ª–∏–Ω–∞
üå∑	—Ç—é–ª—å–ø–∞–Ω	–∫–≤—ñ—Ç–∫–∞|—Ä–æ–∂–µ–≤–∏–π —Ç—é–ª—å–ø–∞–Ω|—Ä–æ—Å–ª–∏–Ω–∞|—Ç—é–ª—å–ø–∞–Ω
üå∏	–≤–∏—à–Ω–µ–≤–∏–π —Ü–≤—ñ—Ç	–≤–∏—à–Ω–µ–≤–∏–π —Ü–≤—ñ—Ç|–≤–∏—à–Ω—è|–∫–≤—ñ—Ç–∫–∞|—Ä–æ—Å–ª–∏–Ω–∞|—Ü–≤—ñ—Ç|—Ü–≤—ñ—Ç –≤–∏—à–Ω—ñ
üåπ	—Ç—Ä–æ—è–Ω–¥–∞	–∫–≤—ñ—Ç–∫–∞|—Ä–æ—Å–ª–∏–Ω–∞|—Ç—Ä–æ—è–Ω–¥–∞|—á–µ—Ä–≤–æ–Ω–∞ —Ç—Ä–æ—è–Ω–¥–∞
üå∫	–≥—ñ–±—ñ—Å–∫—É—Å	–≥—ñ–±—ñ—Å–∫—É—Å|–∫–≤—ñ—Ç–∫–∞|—Ä–æ—Å–ª–∏–Ω–∞
üåª	—Å–æ–Ω—è—à–Ω–∏–∫	–∫–≤—ñ—Ç–∫–∞|—Ä–æ—Å–ª–∏–Ω–∞|—Å–æ–Ω—Ü–µ|—Å–æ–Ω—è—Ö|—Å–æ–Ω—è—à–Ω–∏–∫
üåº	–∂–æ–≤—Ç–∞ –∫–≤—ñ—Ç–∫–∞	–∂–æ–≤—Ç–∞ –∫–≤—ñ—Ç–∫–∞|–∫–≤—ñ—Ç–∫–∞|—Ä–æ–º–∞—à–∫–∞|—Ä–æ—Å–ª–∏–Ω–∞
üåΩ	–∫–∞—á–∞–Ω –∫—É–∫—É—Ä—É–¥–∑–∏	—ó–∂–∞|–∫–∞—á–∞–Ω|–∫–∞—á–∞–Ω –∫—É–∫—É—Ä—É–¥–∑–∏|–∫—É–∫—É—Ä—É–¥–∑–∞|–º–∞—ó—Å
üåæ	—Å–Ω—ñ–ø–æ–∫ —Ä–∏—Å—É	–∫–æ–ª–æ—Å|–∫–æ–ª–æ—Å—Å—è —Ä–∏—Å—É|–ø—à–µ–Ω–∏—Ü—è|—Ä–∏—Å|—Ä–∏—Å–æ–≤–∏–π –∫–æ–ª–æ—Å–æ–∫|—Ä–æ—Å–ª–∏–Ω–∞|—Å–Ω—ñ–ø–æ–∫ —Ä–∏—Å—É
üåø	–ª—ñ–∫–∞—Ä—Å—å–∫–∞ —Ä–æ—Å–ª–∏–Ω–∞	–ª–∏—Å—Ç–æ–∫|–ª–∏—Å—Ç—è|–ª—ñ–∫–∞—Ä—Å—å–∫–∞ —Ä–æ—Å–ª–∏–Ω–∞|—Ä–æ—Å–ª–∏–Ω–∞
üçÄ	—á–æ—Ç–∏—Ä–∏–ª–∏—Å—Ç–∫–æ–≤–∞ –∫–æ–Ω—é—à–∏–Ω–∞	4|–∫–æ–Ω—é—à–∏–Ω–∞|–ª–∏—Å—Ç–æ–∫|–ª–∏—Å—Ç—è|—Ä–æ—Å–ª–∏–Ω–∞|—Ñ–æ—Ä—Ç—É–Ω–∞|—á–æ—Ç–∏—Ä–∏|—á–æ—Ç–∏—Ä–∏–ª–∏—Å—Ç–∞ –∫–æ–Ω—é—à–∏–Ω–∞|—á–æ—Ç–∏—Ä–∏–ª–∏—Å—Ç–∫–æ–≤–∞ –∫–æ–Ω—é—à–∏–Ω–∞|—â–∞—Å—Ç–∏—Ç—å
üçÅ	–∫–ª–µ–Ω–æ–≤–∏–π –ª–∏—Å—Ç–æ–∫	–¥–µ—Ä–µ–≤–æ|–∫–ª–µ–Ω|–∫–ª–µ–Ω–æ–≤–∏–π –ª–∏—Å—Ç–æ–∫|–ª–∏—Å—Ç–æ–∫|–ª–∏—Å—Ç—è|–æ–ø–∞–¥–∞—Ç–∏|–æ—Å—ñ–Ω—å|—Ä–æ—Å–ª–∏–Ω–∞
üçÇ	–æ–ø–∞–ª–µ –ª–∏—Å—Ç—è	–ª–∏—Å—Ç–æ–∫|–ª–∏—Å—Ç–æ–ø–∞–¥|–ª–∏—Å—Ç—è|–æ–ø–∞–¥–∞—Ç–∏|–æ–ø–∞–ª–µ –ª–∏—Å—Ç—è|–æ–ø–∞–ª–∏–π –ª–∏—Å—Ç–æ–∫|–æ—Å—ñ–Ω—å|—Ä–æ—Å–ª–∏–Ω–∞
üçÉ	–ª–∏—Å—Ç—è, —â–æ –∫—Ä—É–∂–ª—è—î –∑–∞ –≤—ñ—Ç—Ä–æ–º	–≤—ñ—Ç–µ—Ä|–¥—É—Ç–∏|–∫—Ä—É–∂–ª—è—Ç–∏|–ª–∏—Å—Ç–æ–∫|–ª–∏—Å—Ç—è|–ª–∏—Å—Ç—è, —â–æ –∫—Ä—É–∂–ª—è—î –∑–∞ –≤—ñ—Ç—Ä–æ–º|—Ä–æ—Å–ª–∏–Ω–∞|—â–æ –∫—Ä—É–∂–ª—è—î –∑–∞ –≤—ñ—Ç—Ä–æ–º
üçÑ	–≥—Ä–∏–±	–≥—Ä–∏–±|–≥—Ä–∏–± —ñ–∑ —à–∞–ø–∏–Ω–∫–æ—é|–º—É—Ö–æ–º–æ—Ä|–ø–ª–æ–¥–æ–≤–µ —Ç—ñ–ª–æ
üçÑ‚Äçüü´	–∫–æ—Ä–∏—á–Ω–µ–≤–∏–π –≥—Ä–∏–±	–≤–µ–≥–µ—Ç–∞—Ä—ñ–∞–Ω—Å—å–∫–∞ —ó–∂–∞|–≤–µ–≥–µ—Ç–∞—Ä—ñ–∞–Ω—Å—å–∫–∏–π|–≥–∞—Ä–Ω—ñ—Ä|–≥—Ä–∏–±–∏|—ó–∂–∞|–∫–æ—Ä–∏—á–Ω–µ–≤–∏–π –≥—Ä–∏–±|–ø–µ—á–µ—Ä–∏—Ü—è|—Ç—Ä—é—Ñ–µ–ª—å|—à–∞–º–ø—ñ–Ω—å–π–æ–Ω|—à–∏—ó—Ç–∞–∫–µ
üçÖ	—Ç–æ–º–∞—Ç	–æ–≤–æ—á|–ø–ª—ñ–¥|–ø–æ–º—ñ–¥–æ—Ä|—Å–µ–Ω—å–π–æ—Ä –ø–æ–º—ñ–¥–æ—Ä|—Ç–æ–º–∞—Ç|—á–µ—Ä–≤–æ–Ω–∏–π –ø–æ–º—ñ–¥–æ—Ä
üçÜ	–±–∞–∫–ª–∞–∂–∞–Ω	–±–∞–∫–ª–∞–∂–∞–Ω|—ó–∂–∞|–æ–≤–æ—á
üçá	–≤–∏–Ω–æ–≥—Ä–∞–¥	–≤–∏–Ω–æ–≥—Ä–∞–¥|–≤–∏–Ω–æ–≥—Ä–∞–¥–∏–Ω–∞|–≤–∏–Ω–æ–≥—Ä–∞–¥–∏–Ω–∏|—ó–∂–∞|–ø–ª—ñ–¥|—è–≥–æ–¥–∏
üçà	–¥–∏–Ω—è	–¥–∏–Ω—è|—ó–∂–∞|–ø–ª—ñ–¥|—Ñ—Ä—É–∫—Ç
üçâ	–∫–∞–≤—É–Ω	—ó–∂–∞|–∫–∞–≤—É–Ω|–ª—ñ—Ç–æ|–ø–ª—ñ–¥
üçä	—Ç–∞–Ω–∂–µ—Ä–∏–Ω	—ó–∂–∞|–º–∞–Ω–¥–∞—Ä–∏–Ω|–æ—Ä–∞–Ω–∂–µ–≤–∏–π|–ø–ª—ñ–¥|–ø–æ–º–∞—Ä–∞–Ω—á|—Ç–∞–Ω–∂–µ—Ä–∏–Ω|—Ñ—Ä—É–∫—Ç
üçã	–ª–∏–º–æ–Ω	–∂–æ–≤—Ç–∏–π –ª–∏–º–æ–Ω|–ª–∏–º–æ–Ω|–ø–ª—ñ–¥|—Ü–∏—Ç—Ä—É—Å
üçã‚Äçüü©	–ª–∞–π–º	–∑–µ–ª–µ–Ω–∏–π|–∫–∏—Å–ª–∏–Ω–∫–∞|–∫–æ–∫—Ç–µ–π–ª—å|–ª–∞–π–º|–ª–∞–π–º–æ–≤–∏–π –ø–∏—Ä—ñ–≥|–º–æ—Ö—ñ—Ç–æ|—Å–∞–ª—å—Å–∞|—Ü–∏—Ç—Ä—É—Å–æ–≤–∏–π
üçå	–±–∞–Ω–∞–Ω	–±–∞–Ω–∞–Ω|—ó–∂–∞|–ø–ª—ñ–¥|—Ñ—Ä—É–∫—Ç
üçç	–∞–Ω–∞–Ω–∞—Å	–∞–Ω–∞–Ω–∞—Å|—ó–∂–∞|–ø–ª—ñ–¥|—Ñ—Ä—É–∫—Ç
üçé	—á–µ—Ä–≤–æ–Ω–µ —è–±–ª—É–∫–æ	—ó–∂–∞|–ø–ª—ñ–¥|—Ñ—Ä—É–∫—Ç|—á–µ—Ä–≤–æ–Ω–µ —è–±–ª—É–∫–æ|—á–µ—Ä–≤–æ–Ω–∏–π|—è–±–ª—É–∫–æ
üçè	–∑–µ–ª–µ–Ω–µ —è–±–ª—É–∫–æ	–µ–ø–ª|–∑–µ–ª–µ–Ω–µ —è–±–ª—É–∫–æ|–∑–µ–ª–µ–Ω–∏–π|—ó–∂–∞|–ø–ª—ñ–¥|—Ñ—Ä—É–∫—Ç|—è–±–ª—É–∫–æ
üçê	–≥—Ä—É—à–∞	–≥—Ä—É—à–∞|—ó–∂–∞|–ø–ª—ñ–¥|—Ñ—Ä—É–∫—Ç
üçë	–ø–µ—Ä—Å–∏–∫	–∞–±—Ä–∏–∫–æ—Å|—ó–∂–∞|–ø–µ—Ä—Å–∏–∫|–ø–ª—ñ–¥|—Ñ—Ä—É–∫—Ç
üçí	–≤–∏—à–Ω—ñ	–≤–∏—à–Ω—ñ|–≤–∏—à–Ω—è|—ó–∂–∞|–ø–ª–æ–¥–∏|—á–µ—Ä–≤–æ–Ω—ñ|—á–µ—Ä–µ—à–Ω—è|—è–≥–æ–¥–∏
üçì	–ø–æ–ª—É–Ω–∏—Ü—è	—ó–∂–∞|–ø–ª—ñ–¥|–ø–æ–ª—É–Ω–∏—Ü—è|—è–≥–æ–¥–∞
üçî	–≥–∞–º–±—É—Ä–≥–µ—Ä	–±—É—Ä–≥–µ—Ä|–≥–∞–º–±—É—Ä–≥–µ—Ä|—ó–∂–∞|—á–∏–∑–±—É—Ä–≥–µ—Ä
üçï	–ø—ñ—Ü–∞	—ó–∂–∞|–ø—ñ—Ü–∞|—Å–∏—Ä|—à–º–∞—Ç–æ–∫
üçñ	–º‚Äô—è—Å–æ –Ω–∞ –∫—ñ—Å—Ç—Ü—ñ	—ó–∂–∞|–∫—ñ—Å—Ç–∫–∞|–º‚Äô—è—Å–æ|–º‚Äô—è—Å–æ –Ω–∞ –∫—ñ—Å—Ç—Ü—ñ
üçó	–Ω—ñ–∂–∫–∞ —Å–≤—ñ–π—Å—å–∫–æ—ó –ø—Ç–∏—Ü—ñ	—ó–∂–∞|–∫—ñ—Å—Ç–∫–∞|–∫—É—Ä–∫–∞|–Ω—ñ–∂–∫–∞|–Ω—ñ–∂–∫–∞ —Å–≤—ñ–π—Å—å–∫–æ—ó –ø—Ç–∏—Ü—ñ|–ø—Ç–∏—Ü—è|—Ü–∏–ø–ª—è "–≥—Ä–∏–ª—å"
üçò	—Ä–∏—Å–æ–≤–∏–π –∫—Ä–µ–∫–µ—Ä	—ó–∂–∞|–∫—Ä–µ–∫–µ—Ä|—Ä–∏—Å|—Ä–∏—Å–æ–≤–∏–π –∫—Ä–µ–∫–µ—Ä
üçô	—Ä–∏—Å–æ–≤–∞ –∫—É–ª—å–∫–∞	—ó–∂–∞|–∫—É–ª—å–∫–∞|—Ä–∏—Å|—Ä–∏—Å–æ–≤–∞ –∫—É–ª—å–∫–∞|—è–ø–æ–Ω—Å—å–∫–∏–π
üçö	–ø—Ä–∏–≥–æ—Ç–æ–≤–∞–Ω–∏–π —Ä–∏—Å	–≤–∞—Ä–µ–Ω–∏–π|—ó–∂–∞|–ø—Ä–∏–≥–æ—Ç–æ–≤–∞–Ω–∏–π —Ä–∏—Å|—Ä–∏—Å
üçõ	—Ä–∏—Å —ñ–∑ –∫–∞—Ä—ñ	—ó–∂–∞|–∫–∞—Ä—ñ|—Ä–∏—Å|—Ä–∏—Å —ñ–∑ –∫–∞—Ä—ñ|—Ä–∏—Å–æ–≤–∏–π —Å—É–ø
üçú	–º–∏—Å–∫–∞, –∑ —è–∫–æ—ó –ø—ñ–¥–Ω—ñ–º–∞—î—Ç—å—Å—è –ø–∞—Ä–∞	–∑ —è–∫–æ—ó –ø—ñ–¥–Ω—ñ–º–∞—î—Ç—å—Å—è –ø–∞—Ä–∞|—ó–∂–∞|–ª–æ–∫—à–∏–Ω–∞|–º–∏—Å–∫–∞|–º–∏—Å–∫–∞, –∑ —è–∫–æ—ó –ø—ñ–¥–Ω—ñ–º–∞—î—Ç—å—Å—è –ø–∞—Ä–∞|–ø–∞—Ä—É–≤–∞—Ç–∏|—Ä–∞–º–µ–Ω|—Å—É–ø
üçù	—Å–ø–∞–≥–µ—Ç—ñ	—ó–∂–∞|—ñ—Ç–∞–ª—ñ–π—Å—å–∫–∞ –∫—É—Ö–Ω—è|–ø–∞—Å—Ç–∞|—Å–ø–∞–≥–µ—Ç—ñ
üçû	—Ö–ª—ñ–±	–±—É—Ö–∞–Ω–µ—Ü—å|—ó–∂–∞|–ø–∞–ª—è–Ω–∏—Ü—è|—Ö–ª—ñ–±|—Ö–ª—ñ–±–∏–Ω–∞
üçü	–∫–∞—Ä—Ç–æ–ø–ª—è —Ñ—Ä—ñ	–∫–∞—Ä—Ç–æ–ø–ª—è|—Ñ—Ä—ñ
üç†	–ø–µ—á–µ–Ω–∏–π –±–∞—Ç–∞—Ç	–±–∞—Ç–∞—Ç|—ó–∂–∞|–æ–≤–æ—á|–ø–µ—á–µ–Ω–∏–π –±–∞—Ç–∞—Ç|–ø–µ—á–µ–Ω–∏–π —Ç–æ–ø—ñ–Ω–∞–º–±—É—Ä|—Å–º–∞–∂–∏—Ç–∏
üç°	—Ä–∏—Å–æ–≤—ñ –∫—É–ª—å–∫–∏ –Ω–∞ —à–ø–∞–∂—Ü—ñ	–¥–∞–Ω–≥–æ|–¥–µ—Å–µ—Ä—Ç|—Ä–∏—Å–æ–≤—ñ –∫—É–ª—å–∫–∏ –Ω–∞ —à–ø–∞–∂—Ü—ñ|—Å–æ–ª–æ–¥–∫–∏–π|—à–∞–º–ø—É—Ä|—è–ø–æ–Ω—Å—å–∫–∏–π
üç¢	–æ–¥–µ–Ω	—ó–∂–∞|–∫–µ–±–∞–±|–º–æ—Ä—Å—å–∫–∏–π|–æ–¥–µ–Ω|—à–∞–º–ø—É—Ä
üç£	—Å—É—à—ñ	—ó–∂–∞|—Å—É—à—ñ
üç§	—Å–º–∞–∂–µ–Ω–∞ –∫—Ä–µ–≤–µ—Ç–∫–∞	—ó–∂–∞|–∫—Ä–µ–≤–µ—Ç–∫–∞|—Å–º–∞–∂–µ–Ω–∞ –∫—Ä–µ–≤–µ—Ç–∫–∞|—Å–º–∞–∂–µ–Ω–∏–π|—Ç–µ–º–ø—É—Ä–∞
üç•	—Ä–∏–±–Ω–∏–π —Ä—É–ª–µ—Ç –∑—ñ —Å–ø—ñ—Ä–∞–ª—å–Ω–∏–º –≤—ñ–∑–µ—Ä—É–Ω–∫–æ–º	–≤–∏–ø—ñ—á–∫–∞|—Ä–∏–±–Ω–∏–π|—Ä–∏–±–Ω–∏–π —Ä—É–ª–µ—Ç –∑—ñ —Å–ø—ñ—Ä–∞–ª—å–Ω–∏–º –≤—ñ–∑–µ—Ä—É–Ω–∫–æ–º|—Ä—É–ª–µ—Ç
üç¶	–º–æ—Ä–æ–∑–∏–≤–æ –≤ —Ä—ñ–∂–∫—É	–¥–µ—Å–µ—Ä—Ç|–º‚Äô—è–∫–µ –º–æ—Ä–æ–∑–∏–≤–æ|–º‚Äô—è–∫–∏–π|–º–æ—Ä–æ–∑–∏–≤–æ|–º–æ—Ä–æ–∑–∏–≤–æ –≤ —Ä—ñ–∂–∫—É|–ø–ª–æ–º–±–∏—Ä|—Å–æ–ª–æ–¥–∫–∏–π
üçß	–ª—å–æ–¥–æ–≤–∞ —Å—Ç—Ä—É–∂–∫–∞	–¥–µ—Å–µ—Ä—Ç|–ª—ñ–¥|–ª—å–æ–¥–æ–≤–∞ —Å—Ç—Ä—É–∂–∫–∞|–º–æ—Ä–æ–∑–∏–≤–æ|—Å–æ–ª–æ–¥–∫–∏–π|—Å—Ç—Ä—É–∂–∫–∞
üç®	–º–æ—Ä–æ–∑–∏–≤–æ	–¥–µ—Å–µ—Ä—Ç|—ó–∂–∞|–º–æ—Ä–æ–∑–∏–≤–æ|—Å–æ–ª–æ–¥–∫–∏–π
üç©	–ø–æ–Ω—á–∏–∫	–¥–µ—Å–µ—Ä—Ç|—ó–∂–∞|–ø–æ–Ω—á–∏–∫|—Å–æ–ª–æ–¥–∫–∏–π
üç™	–ø–µ—á–∏–≤–æ	–¥–µ—Å–µ—Ä—Ç|–ø–µ—á–∏–≤–æ|—Å–æ–ª–æ–¥–∫–∏–π|—à–æ–∫–æ–ª–∞–¥–Ω–µ –ø–µ—á–∏–≤–æ
üç´	–ø–ª–∏—Ç–∫–∞ —à–æ–∫–æ–ª–∞–¥—É	–¥–µ—Å–µ—Ä—Ç|–ø–ª–∏—Ç–∫–∞|–ø–ª–∏—Ç–∫–∞ —à–æ–∫–æ–ª–∞–¥—É|—Å–æ–ª–æ–¥–∫–∏–π|—à–æ–∫–æ–ª–∞–¥
üç¨	—Ü—É–∫–µ—Ä–∫–∞	–¥–µ—Å–µ—Ä—Ç|—Å–æ–ª–æ–¥–∫–∏–π|—Ü—É–∫–µ—Ä–∫–∞
üç≠	–ª—å–æ–¥—è–Ω–∏–∫	–¥–µ—Å–µ—Ä—Ç|–ª—å–æ–¥—è–Ω–∏–∫|—Å–æ–ª–æ–¥–∫–∏–π|—Ü—É–∫–µ—Ä–∫–∞
üçÆ	–∑–∞–≤–∞—Ä–Ω–∏–π –∫—Ä–µ–º	–¥–µ—Å–µ—Ä—Ç|–∑–∞–≤–∞—Ä–Ω–∏–π –∫—Ä–µ–º|—ó–∂–∞|–ø—É–¥–∏–Ω–≥|—Å–æ–ª–æ–¥–∫–∏–π
üçØ	–≥–æ—Ä—â–∏–∫ —ñ–∑ –º–µ–¥–æ–º	–≥–æ—Ä—â–∏–∫|–≥–æ—Ä—â–∏–∫ —ñ–∑ –º–µ–¥–æ–º|–º–µ–¥|—Å–æ–ª–æ–¥–∫–∏–π
üç∞	—Ç—ñ—Å—Ç–µ—á–∫–æ	–≤–∏–ø—ñ—á–∫–∞|–¥–µ—Å–µ—Ä—Ç|—Å–æ–ª–æ–¥–∫–∏–π|—Ç—ñ—Å—Ç–µ—á–∫–æ|—Ç–æ—Ä—Ç|—à–º–∞—Ç–æ–∫
üç±	–æ–±—ñ–¥ —É –∫–æ—Ä–æ–±—Ü—ñ	–±–µ–Ω—Ç–æ|—ó–∂–∞|–Ω–∞–±—ñ—Ä —Å—É—à—ñ|–æ–±—ñ–¥ —É –∫–æ—Ä–æ–±—Ü—ñ|—Å—É—à—ñ|—É–ø–∞–∫–æ–≤–∫–∞
üç≤	–≥–æ—Ä—â–∏–∫ –∑ —ó–∂–µ—é	–≥–æ—Ä—â–∏–∫|–≥–æ—Ä—â–∏–∫ –∑ —ó–∂–µ—é|—ó–∂–∞|–æ–≤–æ—á–µ–≤–∏–π —Å—É–ø|–ø–µ—Ä—à–µ|—Ä–∞–≥—É|—Å—É–ø|—Å—É–ø –∑ –ª–æ–∫—à–∏–Ω–æ—é
üç≥	–≥–æ—Ç—É–≤–∞–Ω–Ω—è —ó–∂—ñ	–≥–æ—Ç—É–≤–∞–Ω–Ω—è —ó–∂—ñ|—ó–∂–∞|–ø–∞—Ç–µ–ª—å–Ω—è|—Å–∫–æ–≤–æ—Ä–æ–¥–∞|—Å–º–∞–∂–∏—Ç–∏|—Å–Ω—ñ–¥–∞–Ω–æ–∫|—è—î—á–Ω—è|—è–π—Ü–µ
üç¥	–≤–∏–¥–µ–ª–∫–∞ —Ç–∞ –Ω—ñ–∂	–≤–µ—á–µ—Ä—è|—ó–∂–∞|—ó—Å—Ç–∏|–∫—É–ª—ñ–Ω–∞—Ä—ñ—è|–æ–±—ñ–¥|—Ä–µ—Å—Ç–æ—Ä–∞–Ω|—Å–º–∞–∫–æ—Ç–∞|—Å–º–∞—á–Ω–æ|—Å–Ω—ñ–¥–∞–Ω–æ–∫|—Å—Ç–æ–ª–æ–≤—ñ –ø—Ä–∏–±–æ—Ä–∏
üçµ	—á–∞–π–Ω–∞ —á–∞—à–∫–∞ –±–µ–∑ –≤—É—à–∫–∞	–≥–∞—Ä—è—á–∏–π|–∑–µ–ª–µ–Ω–∏–π —á–∞–π|—ó–∂–∞|–∫—Ä–µ–º-—Å—É–ø|–Ω–∞–ø—ñ–π|–ø—ñ–∞–ª–∞|—Å—É–ø|—á–∞–π|—á–∞–π–Ω–∞ —á–∞—à–∫–∞ –±–µ–∑ –≤—É—à–∫–∞|—á–∞—à–∫–∞
üç∂	—Å–∞–∫–µ	–±–∞—Ä|–Ω–∞–ø—ñ–π|–ø–∏—Ç–∏|–ø–ª—è—à–∫–∞|—Å–∞–∫–µ|—á–∞—à–∫–∞
üç∑	–∫–µ–ª–∏—Ö –¥–ª—è –≤–∏–Ω–∞	–±–∞—Ä|–≤–∏–Ω–æ|–∫–µ–ª–∏—Ö|–∫–µ–ª–∏—Ö –¥–ª—è –≤–∏–Ω–∞|–Ω–∞–ø—ñ–π|–ø–∏—Ç–∏
üç∏	–±–æ–∫–∞–ª –¥–ª—è –∫–æ–∫—Ç–µ–π–ª—é	–±–∞—Ä|–±–æ–∫–∞–ª|–±–æ–∫–∞–ª –¥–ª—è –∫–æ–∫—Ç–µ–π–ª—é|–∫–æ–∫—Ç–µ–π–ª—å|–º–∞—Ä—Ç—ñ–Ω—ñ|–ø–∏—Ç–∏
üçπ	—Ç—Ä–æ–ø—ñ—á–Ω–∏–π –Ω–∞–ø—ñ–π	–±–∞—Ä|–∫–æ–∫—Ç–µ–π–ª—å|–ø–∏—Ç–∏|—Ç—Ä–æ–ø—ñ—á–Ω–∏–π|—Ç—Ä–æ–ø—ñ—á–Ω–∏–π –Ω–∞–ø—ñ–π
üç∫	–∫—É—Ö–æ–ª—å —ñ–∑ –ø–∏–≤–æ–º	–±–∞—Ä|–±—É–¥—å–º–æ!|–∫—É—Ö–æ–ª—å|–∫—É—Ö–æ–ª—å —ñ–∑ –ø–∏–≤–æ–º|–ø–∏–≤–æ|–ø–∏—Ç–∏
üçª	–∫—É—Ö–ª—ñ –∑ –ø–∏–≤–æ–º, —â–æ —Ü–æ–∫–∞—é—Ç—å—Å—è	–∞–ª–∫–æ–≥–æ–ª—å|–±–∞—Ä|–∫—É—Ö–ª—ñ|–Ω–∞–ø–æ—ó|–ø–∏–≤–æ|–ø–∏—Ç—Ç—è|—Ç–æ—Å—Ç–∏|—Ü–æ–∫–∞–Ω–Ω—è|—Ü–æ–∫–∞—Ç–∏—Å—è
üçº	–ø–ª—è—à–µ—á–∫–∞ –¥–ª—è –Ω–µ–º–æ–≤–ª—è—Ç–∏	–≥–æ–¥—É–≤–∞–Ω–Ω—è|–º–æ–ª–æ–∫–æ|–Ω–µ–º–æ–≤–ª—è|–ø–∏—Ç–∏|–ø–ª—è—à–µ—á–∫–∞|–ø–ª—è—à–µ—á–∫–∞ –¥–ª—è –Ω–µ–º–æ–≤–ª—è—Ç–∏
üçæ	–ø–ª—è—à–∫–∞ –∑ –∫–æ—Ä–∫–æ–º, —â–æ –≤–∏–ª—ñ—Ç–∞—î	–±–∞—Ä|–≤–∏–Ω–æ|–≤—ñ–¥–∫–æ—Ä–∫–æ–≤—É–≤–∞—Ç–∏|—ñ–≥—Ä–∏—Å—Ç–µ|–∫–æ—Ä–æ–∫|–ø–∏—Ç–∏|–ø–ª—è—à–∫–∞|—Å—Ç—Ä—ñ–ª—è—Ç–∏|—Ç–∏—Å–∫|—à–∞–º–ø–∞–Ω—Å—å–∫–µ
üçø	–ø–æ–ø–∫–æ—Ä–Ω	–ø–æ–ø–∫–æ—Ä–Ω
üéÄ	–±–∞–Ω—Ç –∑—ñ —Å—Ç—Ä—ñ—á–∫–∏	–±–∞–Ω—Ç|–±–∞–Ω—Ç –∑—ñ —Å—Ç—Ä—ñ—á–∫–∏|—Ä–æ–∂–µ–≤–∏–π –±–∞–Ω—Ç|—Å–≤—è—Ç–∫—É–≤–∞–Ω–Ω—è|—Å—Ç—Ä—ñ—á–∫–∞
üéÅ	–ø–æ–¥–∞—Ä—É–Ω–æ–∫	–¥–∞—Ä—É–Ω–æ–∫|–∑–∞–ø–∞–∫–æ–≤–∞–Ω–∏–π|–∫–æ—Ä–æ–±–∫–∞|–ø–æ–¥–∞—Ä—É–Ω–æ–∫|—Å–≤—è—Ç–∫—É–≤–∞–Ω–Ω—è|—Å—é—Ä–ø—Ä–∏–∑
üéÇ	—Ç–æ—Ä—Ç –Ω–∞ –¥–µ–Ω—å –Ω–∞—Ä–æ–¥–∂–µ–Ω–Ω—è	–±–∞–∂–∞–Ω–Ω—è|–≤–∏–ø—ñ—á–∫–∞|–¥–µ–Ω—å|–¥–µ—Å–µ—Ä—Ç|–Ω–∞—Ä–æ–¥–∂–µ–Ω–Ω—è|—Å–≤—ñ—á–∫–∏|—Å–≤—è—Ç–∫–æ–≤–∏–π —Ç–æ—Ä—Ç|—Å–≤—è—Ç–∫—É–≤–∞–Ω–Ω—è|—Å–æ–ª–æ–¥–∫–∏–π|—Å–æ–ª–æ–¥–æ—â—ñ|—Ç–æ—Ä—Ç|—Ç–æ—Ä—Ç –Ω–∞ –¥–µ–Ω—å –Ω–∞—Ä–æ–¥–∂–µ–Ω–Ω—è
üéÉ	–ª—ñ—Ö—Ç–∞—Ä-–≥–∞—Ä–±—É–∑	–≥–∞—Ä–±—É–∑|–≥–µ–ª–æ–≤—ñ–Ω|–ª—ñ—Ö—Ç–∞—Ä|–ª—ñ—Ö—Ç–∞—Ä-–≥–∞—Ä–±—É–∑|—Å–≤—è—Ç–∫—É–≤–∞–Ω–Ω—è|—Ö–µ–ª–ª–æ–≤—ñ–Ω|—Ö–µ–ª–ª–æ—É—ñ–Ω|—Ö–µ–ª–æ–≤—ñ–Ω
üéÑ	—Ä—ñ–∑–¥–≤—è–Ω–∞ —è–ª–∏–Ω–∫–∞	–¥–µ—Ä–µ–≤–æ|–ù–æ–≤–∏–π —Ä—ñ–∫|—Ä—ñ–∑–¥–≤–æ|—Ä—ñ–∑–¥–≤—è–Ω–∞ —è–ª–∏–Ω–∫–∞|—Å–≤—è—Ç–∫—É–≤–∞–Ω–Ω—è|—è–ª–∏–Ω–∫–∞
üéÖ	–°–∞–Ω—Ç–∞ –ö–ª–∞—É—Å	–¥—ñ–¥|–¥—ñ–¥ –ú–æ—Ä–æ–∑|–∫–∞–∑–∫–∞|–ù–æ–≤–∏–π —Ä—ñ–∫|—Ä—ñ–∑–¥–≤–æ|–†—ñ–∑–¥–≤–æ|–°–∞–Ω—Ç–∞ –ö–ª–∞—É—Å|–°–≤—è—Ç–∏–π –ú–∏–∫–æ–ª–∞–π|—Å–≤—è—Ç–∫—É–≤–∞–Ω–Ω—è
üéÜ	—Ñ–µ—î—Ä–≤–µ—Ä–∫–∏	—Å–∞–ª—é—Ç|—Å–≤—è—Ç–∫—É–≤–∞–Ω–Ω—è|—Ñ–µ—î—Ä–≤–µ—Ä–∫–∏
üéá	–±–µ–Ω–≥–∞–ª—å—Å—å–∫–∏–π –≤–æ–≥–æ–Ω—å	–±–µ–Ω–≥–∞–ª—å—Å—å–∫–∏–π –≤–æ–≥–æ–Ω—å|—ñ—Å–∫—Ä–∞|—Å–≤—è—Ç–∫—É–≤–∞–Ω–Ω—è|—Ñ–µ—î—Ä–≤–µ—Ä–∫|—Ñ–µ—î—Ä–≤–µ—Ä–∫–∏
üéà	–ø–æ–≤—ñ—Ç—Ä—è–Ω–∞ –∫—É–ª—å–∫–∞	–ø–æ–≤—ñ—Ç—Ä—è–Ω–∞ –∫—É–ª—å–∫–∞|—Å–≤—è—Ç–∫—É–≤–∞–Ω–Ω—è
üéâ	—Ö–ª–æ–ø–∞–≤–∫–∞	–≤–µ—á—ñ—Ä–∫–∞|–≤—ñ—Ç–∞–Ω–Ω—è|—Å–≤—è—Ç–∫—É–≤–∞–Ω–Ω—è|—Å—é—Ä–ø—Ä–∏–∑|—Ö–ª–æ–ø–∞–≤–∫–∞
üéä	–∫—É–ª—å–∫–∞ –∑ –∫–æ–Ω—Ñ–µ—Ç—ñ	–∫–æ–Ω—Ñ–µ—Ç—ñ|–∫—É–ª—å–∫–∞ –∑ –∫–æ–Ω—Ñ–µ—Ç—ñ|—Å–≤—è—Ç–∫—É–≤–∞–Ω–Ω—è
üéã	—Ç–∞–Ω–∞–±–∞—Ç–∞, –≥—ñ–ª–∫–∞ —Ç–∞–Ω–¥–∑–∞–∫—É	–±–∞–Ω–µ—Ä|–≥—ñ–ª–∫–∞ —Ç–∞–Ω–¥–∑–∞–∫—É|–¥–µ—Ä–µ–≤–æ|—Ä–æ—Å–ª–∏–Ω–∞|—Å–≤—è—Ç–∫—É–≤–∞–Ω–Ω—è|—Ç–∞–Ω–∞–±–∞—Ç–∞|—Ç–∞–Ω–∞–±–∞—Ç–∞, –≥—ñ–ª–∫–∞ —Ç–∞–Ω–¥–∑–∞–∫—É|—è–ø–æ–Ω—Å—å–∫–µ —Å–≤—è—Ç–∫—É–≤–∞–Ω–Ω—è|—è–ø–æ–Ω—Å—å–∫–∏–π
üéå	—Å—Ö—Ä–µ—â–µ–Ω—ñ –ø—Ä–∞–ø–æ—Ä–∏	–Ω–∞–≤—Ö—Ä–µ—Å—Ç|–ø—Ä–∞–ø–æ—Ä—Ü—ñ|—Å—Ö—Ä–µ—â–µ–Ω—ñ|—É—Ä–æ—á–∏—Å—Ç—ñ—Å—Ç—å|—è–ø–æ–Ω—Å—å–∫—ñ
üéç	–ø—Ä–∏–∫—Ä–∞—Å–∏ –Ω–∞ —è–ª–∏–Ω–∫—É	–±–∞–º–±—É–∫|–ø—Ä–∏–∫—Ä–∞—Å–∏ –Ω–∞ —è–ª–∏–Ω–∫—É|—Ä–æ—Å–ª–∏–Ω–∞|—Å–≤—è—Ç–∫—É–≤–∞–Ω–Ω—è|—Å–æ—Å–Ω–∞|—è–ø–æ–Ω—Å—å–∫–∏–π
üéé	—è–ø–æ–Ω—Å—å–∫—ñ –ª—è–ª—å–∫–∏	–ª—è–ª—å–∫–∞|–ª—è–ª—å–∫–∏|—Å–≤—è—Ç–∫—É–≤–∞–Ω–Ω—è|—Ñ–µ—Å—Ç–∏–≤–∞–ª—å|—è–ø–æ–Ω—Å—å–∫–∏–π|—è–ø–æ–Ω—Å—å–∫—ñ –ª—è–ª—å–∫–∏
üéè	–≤—ñ—Ç—Ä–æ–≤–∫–∞–∑ —É —Ñ–æ—Ä–º—ñ –∫–æ—Ä–æ–ø—ñ–≤	–≤—ñ—Ç—Ä–æ–≤–∫–∞–∑ —É —Ñ–æ—Ä–º—ñ –∫–æ—Ä–æ–ø—ñ–≤|–∫–∞—Ä–ø|—Å–≤—è—Ç–∫—É–≤–∞–Ω–Ω—è|—Ç—Ä–∞–Ω—Å–ø–∞—Ä–∞–Ω—Ç|—Ç—Ä–∞–Ω—Å–ø–∞—Ä–∞–Ω—Ç —ñ–∑ –∫–∞—Ä–ø–∞–º–∏
üéê	–∫–∏—Ç–∞–π—Å—å–∫—ñ –¥–∑–≤—ñ–Ω–æ—á–∫–∏	–≤—ñ—Ç–µ—Ä|–¥–∑–≤—ñ–Ω–æ—á–∫–∏|–¥–∑–≤–æ–Ω–∏–∫|–∫–∏—Ç–∞–π—Å—å–∫—ñ –¥–∑–≤—ñ–Ω–æ—á–∫–∏|—Å–≤—è—Ç–∫—É–≤–∞–Ω–Ω—è
üéë	—Ü–µ—Ä–µ–º–æ–Ω—ñ—è –≤—à–∞–Ω—É–≤–∞–Ω–Ω—è –º—ñ—Å—è—Ü—è	–º—ñ—Å—è—Ü—å|—Å–≤—è—Ç–∫—É–≤–∞–Ω–Ω—è|—Ü–µ—Ä–µ–º–æ–Ω—ñ—è|—Ü–µ—Ä–µ–º–æ–Ω—ñ—è –≤—à–∞–Ω—É–≤–∞–Ω–Ω—è –º—ñ—Å—è—Ü—è
üéí	—à–∫—ñ–ª—å–Ω–∏–π —Ä—é–∫–∑–∞–∫	–Ω–∞–≤—á–∞–Ω–Ω—è|—Ä–∞–Ω–µ—Ü—å|—Å—É–º–∫–∞|—à–∫—ñ–ª—å–Ω–∏–π –ø–æ—Ä—Ç—Ñ–µ–ª—å|—à–∫—ñ–ª—å–Ω–∏–π —Ä—é–∫–∑–∞–∫|—à–∫–æ–ª–∞
üéì	–∫–≤–∞–¥—Ä–∞—Ç–Ω–∞ –∞–∫–∞–¥–µ–º—ñ—á–Ω–∞ —à–∞–ø–æ—á–∫–∞	–∞–∫–∞–¥–µ–º—ñ–∫|–±–æ–Ω–µ—Ç|–≤–∏–ø—É—Å–∫|–∫–∞–ø–µ–ª—é—Ö|–∫–≤–∞–¥—Ä–∞—Ç–Ω–∞ –∞–∫–∞–¥–µ–º—ñ—á–Ω–∞ —à–∞–ø–æ—á–∫–∞|–æ–¥—è–≥|–ø—Ä–æ—Ñ–µ—Å–æ—Ä|—à–∞–ø–∫–∞
üé†	–∫–æ–Ω–∏–∫ –Ω–∞ –∫–∞—Ä—É—Å–µ–ª—ñ	–∫–∞—Ä—É—Å–µ–ª—å|–∫—ñ–Ω—å|–∫–æ–Ω–∏–∫ –Ω–∞ –∫–∞—Ä—É—Å–µ–ª—ñ|–ª–∏—Ü–∞—Ä|–ª–∏—Ü–∞—Ä—Å—å–∫–∏–π –∫—ñ–Ω—å
üé°	—á–æ—Ä—Ç–æ–≤–µ –∫–æ–ª–µ—Å–æ	–∫–æ–ª–µ—Å–æ|–∫–æ–ª–µ—Å–æ –æ–≥–ª—è–¥—É|–æ–≥–ª—è–¥|–ø–∞—Ä–∫ —Ä–æ–∑–≤–∞–≥|—á–æ—Ä—Ç–æ–≤–µ –∫–æ–ª–µ—Å–æ
üé¢	–∞–º–µ—Ä–∏–∫–∞–Ω—Å—å–∫—ñ –≥—ñ—Ä–∫–∏	–∞–º–µ—Ä–∏–∫–∞–Ω—Å—å–∫–∏–π|–∞–º–µ—Ä–∏–∫–∞–Ω—Å—å–∫—ñ –≥—ñ—Ä–∫–∏|–≥—ñ—Ä–∫–∏|–ø–∞—Ä–∫ —Ä–æ–∑–≤–∞–≥
üé£	—Ä–∏–±–∞—Ü—å–∫–∞ –≤—É–¥–∫–∞	–≤—É–¥–∫–∞|–≤—É–¥–∫–∞ —ñ —Ä–∏–±–∞|—Ä–∏–±–∞|—Ä–∏–±–∞–ª–∫–∞|—Ä–∏–±–∞—Ü—å–∫–∞ –≤—É–¥–∫–∞
üé§	–º—ñ–∫—Ä–æ—Ñ–æ–Ω	–∫–∞—Ä–∞–æ–∫–µ|–º—ñ–∫—Ä–æ—Ñ–æ–Ω
üé•	–∫—ñ–Ω–æ–∫–∞–º–µ—Ä–∞	–∑–π–æ–º–∫–∞|–∫–∞–º–µ—Ä–∞|–∫—ñ–Ω–æ|–∫—ñ–Ω–æ–∫–∞–º–µ—Ä–∞|—Ñ—ñ–ª—å–º
üé¶	–∫—ñ–Ω–µ–º–∞—Ç–æ–≥—Ä–∞—Ñ	–∑–π–æ–º–∫–∞|–∫–∞–º–µ—Ä–∞|–∫—ñ–Ω–µ–º–∞—Ç–æ–≥—Ä–∞—Ñ|–∫—ñ–Ω–æ|—Ñ—ñ–ª—å–º
üéß	–Ω–∞–≤—É—à–Ω–∏–∫–∏	–Ω–∞–≤—É—à–Ω–∏–∫–∏
üé®	–ø–∞–ª—ñ—Ç—Ä–∞ —Ö—É–¥–æ–∂–Ω–∏–∫–∞	–∫–∞—Ä—Ç–∏–Ω–∞|–∫–æ–ª—å–æ—Ä–∏|–º–∏—Å—Ç–µ—Ü—Ç–≤–æ|–º—É–∑–µ–π|–ø–∞–ª—ñ—Ç—Ä–∞|–ø–∞–ª—ñ—Ç—Ä–∞ —Ö—É–¥–æ–∂–Ω–∏–∫–∞
üé©	—Ü–∏–ª—ñ–Ω–¥—Ä (–∫–∞–ø–µ–ª—é—Ö)	–∫–∞–ø–µ–ª—é—Ö|–æ–¥—è–≥|—Ñ–æ–∫—É—Å|—Ü–∏–ª—ñ–Ω–¥—Ä|—Ü–∏–ª—ñ–Ω–¥—Ä (–∫–∞–ø–µ–ª—é—Ö)|—á–æ–ª–æ–≤—ñ–∫
üé™	—Ü–∏—Ä–∫–æ–≤–µ —à–∞—Ç—Ä–æ	–Ω–∞–º–µ—Ç|—Ü–∏—Ä–∫|—Ü–∏—Ä–∫–æ–≤–µ —à–∞—Ç—Ä–æ|—Ü–∏—Ä–∫–æ–≤–∏–π –Ω–∞–º–µ—Ç
üé´	–∫–≤–∏—Ç–æ–∫	–≤—Ö—ñ–¥–Ω–∏–π|–∫–≤–∏—Ç–æ–∫
üé¨	–∫—ñ–Ω–æ—Ö–ª–æ–ø–∞–≤–∫–∞	–∑–π–æ–º–∫–∞|–∫—ñ–Ω–æ—Ö–ª–æ–ø–∞–≤–∫–∞|—Ñ—ñ–ª—å–º|—Ö–ª–æ–ø–∞–≤–∫–∞
üé≠	—Ç–µ–∞—Ç—Ä–∞–ª—å–Ω–µ –º–∏—Å—Ç–µ—Ü—Ç–≤–æ	–±–∞–ª|–≤–µ–Ω–µ—Ü—ñ–∞–Ω—Å—å–∫–∏–π|–≤–µ–Ω–µ—Ü—ñ–π—Å—å–∫–∏–π|–≤–∏—Å—Ç–∞–≤–∞|–º–∞—Å–∫–∞|–º–∞—Å–∫–∞—Ä–∞–¥|—Ç–µ–∞—Ç—Ä
üéÆ	—ñ–≥—Ä–æ–≤–∏–π –∫–æ–Ω—Ç—Ä–æ–ª–µ—Ä	–≤—ñ–¥–µ–æ–≥—Ä–∞|–≥—Ä–∞|–¥–∂–æ–π—Å—Ç–∏–∫|—ñ–≥—Ä–æ–≤–∏–π –∫–æ–Ω—Ç—Ä–æ–ª–µ—Ä|–∫–æ–Ω—Ç—Ä–æ–ª–µ—Ä|—É–ø—Ä–∞–≤–ª—ñ–Ω–Ω—è
üéØ	–º—ñ—à–µ–Ω—å —ñ–∑ –ø—Ä—è–º–∏–º –≤–ª—É—á–µ–Ω–Ω—è–º	¬´—è–±–ª—É—á–∫–æ¬ª|–≤ —è–±–ª—É—á–∫–æ|–≤–ª—É—á–µ–Ω–Ω—è|–≥—Ä–∞|–¥—Ä–æ—Ç–∏–∫|–º—ñ—à–µ–Ω—å —ñ–∑ –ø—Ä—è–º–∏–º –≤–ª—É—á–µ–Ω–Ω—è–º|–ø—Ä—è–º–µ –ø–æ–ø–∞–¥–∞–Ω–Ω—è|—Ç–æ—á–Ω–æ|—Ü—ñ–ª—å
üé∞	–≥—Ä–∞–ª—å–Ω–∏–π –∞–≤—Ç–æ–º–∞—Ç	–∞–∑–∞—Ä—Ç|–í–µ–≥–∞—Å|–≤–µ–∑—ñ–Ω–Ω—è|–≤–∏–≥—Ä–∞—à|–≥—Ä–∞|–≥—Ä–∞–ª—å–Ω–∏–π –∞–≤—Ç–æ–º–∞—Ç|–¥–∂–µ–∫–ø–æ—Ç|–∑–∞–ª–µ–∂–Ω—ñ—Å—Ç—å|—ñ–≥—Ä–æ–≤–∏–π|—Ñ–∞—Ä—Ç
üé±	–±—ñ–ª—å—è—Ä–¥–Ω–∞ –∫—É–ª—è 8	8|–±—ñ–ª—å—è—Ä–¥|–±—ñ–ª—å—è—Ä–¥–Ω–∞ –∫—É–ª—è|–±—ñ–ª—å—è—Ä–¥–Ω–∞ –∫—É–ª—è 8|–≤—ñ—Å—ñ–º|–∫—É–ª—è|—Å–ø–æ—Ä—Ç
üé≤	–≥—Ä–∞–ª—å–Ω–∞ –∫—ñ—Å—Ç—å	–≥—Ä–∞|–≥—Ä–∞–ª—å–Ω–∞ –∫—ñ—Å—Ç—å|–≥—Ä–∞–ª—å–Ω–∏–π –∫—É–±–∏–∫|–∫–∞–∑–∏–Ω–æ|–∫—É–±–∏–∫
üé≥	–∫—É–ª—è —ñ –∫–µ–≥–ª—ñ –¥–ª—è –±–æ—É–ª—ñ–Ω–≥—É	–±–æ—É–ª—ñ–Ω–≥|–≥—Ä–∞|–∫—É–ª—è —ñ –∫–µ–≥–ª—ñ –¥–ª—è –±–æ—É–ª—ñ–Ω–≥—É|–º‚Äô—è—á|—Å–ø–æ—Ä—Ç
üé¥	–≥—Ä–∞–ª—å–Ω—ñ –∫–∞—Ä—Ç–∏ –∑ –∫–≤—ñ—Ç–∞–º–∏ (—Ö–∞–Ω–∞—Ñ—É–¥–∞)	–≥—Ä–∞|–≥—Ä–∞–ª—å–Ω—ñ –∫–∞—Ä—Ç–∏ –∑ –∫–≤—ñ—Ç–∞–º–∏|–≥—Ä–∞–ª—å–Ω—ñ –∫–∞—Ä—Ç–∏ –∑ –∫–≤—ñ—Ç–∞–º–∏ (—Ö–∞–Ω–∞—Ñ—É–¥–∞)|–≥—Ä–∞—Ç–∏|–∫–∞—Ä—Ç–∞|—Ö–∞–Ω–∞—Ñ—É–¥–∞|—è–ø–æ–Ω—Å—å–∫–∏–π
üéµ	–º—É–∑–∏—á–Ω–∞ –Ω–æ—Ç–∞	–º—É–∑–∏—á–Ω–∞ –Ω–æ—Ç–∞|–º—É–∑–∏—á–Ω–∏–π|–Ω–æ—Ç–∞
üé∂	–º—É–∑–∏—á–Ω—ñ –Ω–æ—Ç–∏	–º—É–∑–∏–∫–∞|–º—É–∑–∏—á–Ω–∏–π|–º—É–∑–∏—á–Ω—ñ –Ω–æ—Ç–∏|–Ω–æ—Ç–∞|–Ω–æ—Ç–∏
üé∑	—Å–∞–∫—Å–æ—Ñ–æ–Ω	—ñ–Ω—Å—Ç—Ä—É–º–µ–Ω—Ç|–º—É–∑–∏–∫–∞|–º—É–∑–∏—á–Ω–∏–π|—Å–∞–∫—Å–æ—Ñ–æ–Ω
üé∏	–≥—ñ—Ç–∞—Ä–∞	–≥—ñ—Ç–∞—Ä–∞|—ñ–Ω—Å—Ç—Ä—É–º–µ–Ω—Ç|–º—É–∑–∏—á–Ω–∏–π
üéπ	–º—É–∑–∏—á–Ω–∞ –∫–ª–∞–≤—ñ–∞—Ç—É—Ä–∞	—ñ–Ω—Å—Ç—Ä—É–º–µ–Ω—Ç|–∫–ª–∞–≤—ñ–∞—Ç—É—Ä–∞|–º—É–∑–∏—á–Ω–∞ –∫–ª–∞–≤—ñ–∞—Ç—É—Ä–∞|–º—É–∑–∏—á–Ω–∏–π|–ø—ñ–∞–Ω—ñ–Ω–æ
üé∫	—Ç—Ä—É–±–∞	—ñ–Ω—Å—Ç—Ä—É–º–µ–Ω—Ç|–º—É–∑–∏—á–Ω–∏–π|—Ç—Ä—É–±–∞
üéª	—Å–∫—Ä–∏–ø–∫–∞	—ñ–Ω—Å—Ç—Ä—É–º–µ–Ω—Ç|–º—É–∑–∏—á–Ω–∏–π|—Å–∫—Ä–∏–ø–∫–∞
üéº	–ø–∞—Ä—Ç–∏—Ç—É—Ä–∞	–º—É–∑–∏—á–Ω–∏–π|–Ω–æ—Ç–∏|–ø–∞—Ä—Ç–∏—Ç—É—Ä–∞|—Å–∫—Ä–∏–ø–∫–æ–≤–∏–π –∫–ª—é—á
üéΩ	–±—ñ–≥–æ–≤–∞ —Ç–µ–Ω—ñ—Å–∫–∞	–±—ñ–≥|–±—ñ–≥–æ–≤–∞ —Ç–µ–Ω—ñ—Å–∫–∞|—Å–æ—Ä–æ—á–∫–∞|—Å–ø–æ—Ä—Ç–∏–≤–Ω–∞ —Ñ–æ—Ä–º–∞|—Å—Ç—Ä—ñ—á–∫–∞|—Ñ—É—Ç–±–æ–ª–∫–∞
üéæ	—Ç–µ–Ω—ñ—Å–Ω–∏–π –º‚Äô—è—á	–º‚Äô—è—á|—Ä–∞–∫–µ—Ç–∫–∞|—Å–ø–æ—Ä—Ç|—Ç–µ–Ω—ñ—Å|—Ç–µ–Ω—ñ—Å–Ω–∏–π –º‚Äô—è—á
üéø	–ª–∏–∂—ñ	–ª–∏–∂—ñ|—Å–Ω—ñ–≥|—Å–ø–æ—Ä—Ç
üèÄ	–±–∞—Å–∫–µ—Ç–±–æ–ª—å–Ω–∏–π –º‚Äô—è—á	–±–∞—Å–∫–µ—Ç–±–æ–ª—å–Ω–∏–π –º‚Äô—è—á|–∫—ñ–ª—å—Ü–µ|–º‚Äô—è—á|—Å–ø–æ—Ä—Ç
üèÅ	–∫–∞—Ä—Ç–∞—Ç–∏–π –ø—Ä–∞–ø–æ—Ä	–∫–∞—Ä—Ç–∞—Ç–∏–π|–∫–∞—Ä—Ç–∞—Ç–∏–π –ø—Ä–∞–ø–æ—Ä|–∫–ª—ñ—á–∞—Å—Ç–∏–π|–ø–µ—Ä–µ–≥–æ–Ω–∏|–ø—Ä–∞–ø–æ—Ä –¥–ª—è –ø–µ—Ä–µ–≥–æ–Ω—ñ–≤|—Ñ—ñ–Ω—ñ—à
üèÇ	—Å–Ω–æ—É–±–æ—Ä–¥–∏—Å—Ç	–ª–∏–∂—ñ|—Å–Ω—ñ–≥|—Å–Ω–æ—É–±–æ—Ä–¥|—Å–Ω–æ—É–±–æ—Ä–¥–∏—Å—Ç|—Å–ø–æ—Ä—Ç
üèÉ	–ª—é–¥–∏–Ω–∞, —â–æ –±—ñ–∂–∏—Ç—å	–±—ñ–≥|–∑–º–∞–≥–∞–Ω–Ω—è|–ª—é–¥–∏–Ω–∞|–º–∞—Ä–∞—Ñ–æ–Ω|–Ω–∞–≤–∑–¥–æ–≥—ñ–Ω|–ø–æ—Å–ø—ñ—à–∞—Ç–∏|—Å–ø–æ—Ä—Ç|—Å–ø–æ—Ä—Ç—Å–º–µ–Ω|—à–≤–∏–¥–∫–∏–π
üèÑ	–ª—é–¥–∏–Ω–∞, —â–æ –∑–∞–π–º–∞—î—Ç—å—Å—è —Å–µ—Ä—Ñ—ñ–Ω–≥–æ–º	–ª—é–¥–∏–Ω–∞|–æ–∫–µ–∞–Ω|–ø–ª—è–∂|—Å–µ—Ä—Ñ–µ—Ä|—Å–µ—Ä—Ñ—ñ–Ω–≥|—Å–ø–æ—Ä—Ç—Å–º–µ–Ω|—Ö–≤–∏–ª—ñ
üèÖ	—Å–ø–æ—Ä—Ç–∏–≤–Ω–∞ –º–µ–¥–∞–ª—å	–∑–æ–ª–æ—Ç–∞ –º–µ–¥–∞–ª—å|–º–µ–¥–∞–ª—å|—Å–ø–æ—Ä—Ç–∏–≤–Ω–∞ –º–µ–¥–∞–ª—å
üèÜ	–ø—Ä–∏–∑	–≤–∏–≥—Ä–∞—à|–∫—É–±–æ–∫|–Ω–∞–≥–æ—Ä–æ–¥–∞|–ø–µ—Ä–µ–º–æ–≥–∞|–ø—Ä–∏–∑|—Ç—Ä–æ—Ñ–µ–π
üèá	–∫—ñ–Ω–Ω—ñ –ø–µ—Ä–µ–≥–æ–Ω–∏	–±—ñ–≥–æ–≤–∏–π –∫—ñ–Ω—å|–∂–æ–∫–µ–π|–∫—ñ–Ω–Ω—ñ –ø–µ—Ä–µ–≥–æ–Ω–∏|–∫—ñ–Ω—å|–ø–µ—Ä–µ–≥–æ–Ω–∏|—Å–ø–æ—Ä—Ç
üèà	–º º—è—á –¥–ª—è –∞–º–µ—Ä–∏–∫–∞–Ω—Å—å–∫–æ–≥–æ —Ñ—É—Ç–±–æ–ª—É	–∞–º–µ—Ä–∏–∫–∞–Ω—Å—å–∫–∏–π|–º‚Äô—è—á|–º‚Äô—è—á –¥–ª—è –≥—Ä–∏ –≤ –∞–º–µ—Ä–∏–∫–∞–Ω—Å—å–∫–∏–π —Ñ—É—Ç–±–æ–ª|–º º—è—á –¥–ª—è –∞–º–µ—Ä–∏–∫–∞–Ω—Å—å–∫–æ–≥–æ —Ñ—É—Ç–±–æ–ª—É|—Å–ø–æ—Ä—Ç|—Ñ—É—Ç–±–æ–ª
üèâ	–º º—è—á –¥–ª—è —Ä–µ–≥–±—ñ	–∞–º–µ—Ä–∏–∫–∞–Ω—Å—å–∫–∏–π —Ñ—É—Ç–±–æ–ª|–º‚Äô—è—á|–º‚Äô—è—á –¥–ª—è –≥—Ä–∏ –≤ —Ä–µ–≥–±—ñ|–º º—è—á –¥–ª—è —Ä–µ–≥–±—ñ|—Ä–µ–≥–±—ñ|—Å–ø–æ—Ä—Ç|—Ñ—É—Ç–±–æ–ª
üèä	–ª—é–¥–∏–Ω–∞, —â–æ –ø–ª–∏–≤–µ	–≤–æ–¥–∞|–≤–æ–¥–Ω–∏–π —Å–ø–æ—Ä—Ç|–ª—é–¥–∏–Ω–∞|–ø–ª–∞–≤–∞–Ω–Ω—è|–ø–ª–∞–≤–∞—Ç–∏|–ø–ª–∞–≤–µ—Ü—å|—Å–ø–æ—Ä—Ç|—Å–ø–æ—Ä—Ç—Å–º–µ–Ω|—Ç—Ä–∏–∞—Ç–ª–æ–Ω
üèè	–±–∏—Ç–∞ —ñ –º º—è—á –¥–ª—è –∫—Ä–∏–∫–µ—Ç—É	–±–∏—Ç–∞|–±–∏—Ç–∞ —ñ –º º—è—á –¥–ª—è –∫—Ä–∏–∫–µ—Ç—É|–≥—Ä–∞|–∫—Ä–∏–∫–µ—Ç|–º‚Äô—è—á|—Å–ø–æ—Ä—Ç
üèê	–≤–æ–ª–µ–π–±–æ–ª—å–Ω–∏–π –º‚Äô—è—á	–≤–æ–ª–µ–π–±–æ–ª|–≤–æ–ª–µ–π–±–æ–ª—å–Ω–∏–π –º‚Äô—è—á|–≥—Ä–∞|–º‚Äô—è—á|—Å–ø–æ—Ä—Ç
üèë	–∫–ª—é—á–∫–∞ —ñ –º º—è—á –¥–ª—è —Ö–æ–∫–µ—é –Ω–∞ —Ç—Ä–∞–≤—ñ	–≥—Ä–∞|–∫–ª—é—á–∫–∞|–∫–ª—é—á–∫–∞ —ñ –º º—è—á –¥–ª—è —Ö–æ–∫–µ—é –Ω–∞ —Ç—Ä–∞–≤—ñ|–º‚Äô—è—á|–ø–æ–ª–µ|—Ö–æ–∫–µ–π|—Ö–æ–∫–µ–π –Ω–∞ —Ç—Ä–∞–≤—ñ
üèí	–∫–ª—é—á–∫–∞ —ñ —à–∞–π–±–∞ –¥–ª—è —Ö–æ–∫–µ—é	–≥—Ä–∞|–∫–ª—é—á–∫–∞|–∫–ª—é—á–∫–∞ —ñ —à–∞–π–±–∞ –¥–ª—è —Ö–æ–∫–µ—é|–ª—ñ–¥|—Å–ø–æ—Ä—Ç|—Ö–æ–∫–µ–π|—à–∞–π–±–∞
üèì	—Ä–∞–∫–µ—Ç–∫–∞ —ñ –∫—É–ª—å–∫–∞ –¥–ª—è –ø—ñ–Ω–≥-–ø–æ–Ω–≥—É	–∫—É–ª—å–∫–∞|–ø—ñ–Ω–≥-–ø–æ–Ω–≥|—Ä–∞–∫–µ—Ç–∫–∞|—Ä–∞–∫–µ—Ç–∫–∞ —ñ –∫—É–ª—å–∫–∞ –¥–ª—è –ø—ñ–Ω–≥-–ø–æ–Ω–≥—É|—Å–ø–æ—Ä—Ç|—Å—Ç—ñ–ª|—Ç–µ–Ω—ñ—Å
üè†	–±—É–¥–∏–Ω–æ–∫	–±—É–¥–∏–Ω–æ–∫|–±—É–¥—ñ–≤–ª—è|–≤–¥–æ–º–∞|–¥—ñ–º
üè°	–±—É–¥–∏–Ω–æ–∫ —ñ–∑ —Å–∞–¥–æ–º	–±—É–¥–∏–Ω–æ–∫|–±—É–¥–∏–Ω–æ–∫ —ñ–∑ —Å–∞–¥–æ–º|–±—É–¥—ñ–≤–ª—è|–¥—ñ–º|—Å–∞–¥
üè¢	–æ—Ñ—ñ—Å–Ω–∞ –±—É–¥—ñ–≤–ª—è	–±—É–¥—ñ–≤–ª—è|–æ—Ñ—ñ—Å–Ω–∞ –±—É–¥—ñ–≤–ª—è
üè£	—è–ø–æ–Ω—Å—å–∫–µ –ø–æ—à—Ç–æ–≤–µ –≤—ñ–¥–¥—ñ–ª–µ–Ω–Ω—è	–±—É–¥—ñ–≤–ª—è|–ø–æ—à—Ç–∞|—è–ø–æ–Ω—Å—å–∫–∞ –ø–æ—à—Ç–∞|—è–ø–æ–Ω—Å—å–∫–µ –ø–æ—à—Ç–æ–≤–µ –≤—ñ–¥–¥—ñ–ª–µ–Ω–Ω—è|—è–ø–æ–Ω—Å—å–∫–∏–π
üè§	–ø–æ—à—Ç–æ–≤–µ –≤—ñ–¥–¥—ñ–ª–µ–Ω–Ω—è	–±—É–¥—ñ–≤–ª—è|—î–≤—Ä–æ–ø–µ–π—Å—å–∫–∏–π|–ø–æ—à—Ç–∞|–ø–æ—à—Ç–æ–≤–µ –≤—ñ–¥–¥—ñ–ª–µ–Ω–Ω—è
üè•	–ª—ñ–∫–∞—Ä–Ω—è	–±—É–¥—ñ–≤–ª—è|–≥–æ—Å–ø—ñ—Ç–∞–ª—å|–ª—ñ–∫–∞—Ä|–ª—ñ–∫–∞—Ä–Ω—è|–º–µ–¥–∏—Ü–∏–Ω–∞
üè¶	–±–∞–Ω–∫	–±–∞–Ω–∫|–±—É–¥—ñ–≤–ª—è
üèß	—Å–∏–º–≤–æ–ª –±–∞–Ω–∫–æ–º–∞—Ç–∞	–±–∞–Ω–∫—ñ–≤—Å—å–∫–∏–π –∞–≤—Ç–æ–º–∞—Ç|–±–∞–Ω–∫–æ–º–∞—Ç|–≥–æ—Ç—ñ–≤–∫–∞|–∑–Ω–∞–∫ –±–∞–Ω–∫–æ–º–∞—Ç–∞|–∑–Ω—è—Ç–∏ –≥—Ä–æ—à—ñ|—Å–∏–º–≤–æ–ª –±–∞–Ω–∫–æ–º–∞—Ç–∞|—Ç–µ—Ä–º—ñ–Ω–∞–ª —Å–∞–º–æ–æ–±—Å–ª—É–≥–æ–≤—É–≤–∞–Ω–Ω—è
üè®	–≥–æ—Ç–µ–ª—å	–±—É–¥—ñ–≤–ª—è|–≥–æ—Ç–µ–ª—å
üè©	–≥–æ—Ç–µ–ª—å –∫–æ—Ö–∞–Ω–Ω—è	–±—É–¥—ñ–≤–ª—è|–≥–æ—Ç–µ–ª—å|–≥–æ—Ç–µ–ª—å –¥–ª—è –∑–∞–∫–æ—Ö–∞–Ω–∏—Ö|–∫–æ—Ö–∞–Ω–Ω—è|–º–æ—Ç–µ–ª—å
üè™	—Ü—ñ–ª–æ–¥–æ–±–æ–≤–∏–π –º–∞–≥–∞–∑–∏–Ω	–±—É–¥—ñ–≤–ª—è|–º–∞–≥–∞–∑–∏–Ω|—Ü—ñ–ª–æ–¥–æ–±–æ–≤–∏–π
üè´	—à–∫–æ–ª–∞	–±—É–¥—ñ–≤–ª—è|—à–∫–æ–ª–∞
üè¨	—É–Ω—ñ–≤–µ—Ä–º–∞–≥	–±–∞–Ω–∫|–±—É–¥—ñ–≤–ª—è|–æ—Ñ—ñ—Å|—É–Ω—ñ–≤–µ—Ä–º–∞–≥
üè≠	—Ñ–∞–±—Ä–∏–∫–∞	–±—É–¥—ñ–≤–ª—è|–∑–∞–≤–æ–¥|—Ñ–∞–±—Ä–∏–∫–∞
üèÆ	—á–µ—Ä–≤–æ–Ω–∏–π –ø–∞–ø–µ—Ä–æ–≤–∏–π –ª—ñ—Ö—Ç–∞—Ä	–±–∞—Ä|–ª—ñ—Ö—Ç–∞—Ä|–ª—ñ—Ö—Ç–∞—Ä —ñ–∑–∞–∫–∞–π–∞|—Å–≤—ñ—Ç–ª–æ|—á–µ—Ä–≤–æ–Ω–∏–π|—á–µ—Ä–≤–æ–Ω–∏–π –ø–∞–ø–µ—Ä–æ–≤–∏–π –ª—ñ—Ö—Ç–∞—Ä|—è–ø–æ–Ω—Å—å–∫–∏–π
üèØ	—è–ø–æ–Ω—Å—å–∫–∏–π –∑–∞–º–æ–∫	–±—É–¥—ñ–≤–ª—è|–ø–∞–≥–æ–¥–∞|—è–ø–æ–Ω—Å—å–∫–∏–π –∑–∞–º–æ–∫
üè∞	–∑–∞–º–æ–∫	–±—É–¥—ñ–≤–ª—è|—î–≤—Ä–æ–ø–µ–π—Å—å–∫–∞|–∑–∞–º–æ–∫|—Ñ–æ—Ä—Ç–µ—Ü—è
üè¥	—á–æ—Ä–Ω–∏–π –ø—Ä–∞–ø–æ—Ä	–º–∞–π–æ—Ä–∏—Ç—å|—á–æ—Ä–Ω–∏–π –ø—Ä–∞–ø–æ—Ä
üè∏	—Ä–∞–∫–µ—Ç–∫–∞ —ñ –≤–æ–ª–∞–Ω –¥–ª—è –±–∞–¥–º—ñ–Ω—Ç–æ–Ω—É	–±–∞–¥–º—ñ–Ω—Ç–æ–Ω|–≤–æ–ª–∞–Ω|–≤–æ–ª–∞–Ω—á–∏–∫|–≥—Ä–∞|—Ä–∞–∫–µ—Ç–∫–∞|—Ä–∞–∫–µ—Ç–∫–∞ —ñ –≤–æ–ª–∞–Ω –¥–ª—è –±–∞–¥–º—ñ–Ω—Ç–æ–Ω—É|—Å–ø–æ—Ä—Ç
üèπ	–ª—É–∫ —ñ —Å—Ç—Ä—ñ–ª–∞	–∑–±—Ä–æ—è|–∑–Ω–∞—Ä—è–¥–¥—è|–∑–æ–¥—ñ–∞–∫|–ª—É–∫|–ª—É–∫ —ñ —Å—Ç—Ä—ñ–ª–∞|–ª—É—á–Ω–∏–∫|—Å—Ç—Ä—ñ–ª–∞|—Å—Ç—Ä—ñ–ª–µ—Ü—å|–°—Ç—Ä—ñ–ª–µ—Ü—å
üè∫	–∞–º—Ñ–æ—Ä–∞	–∞–º—Ñ–æ—Ä–∞|–≤–æ–¥–æ–ª—ñ–π|–≥–ª–µ–∫|–∑–æ–¥—ñ–∞–∫|–∫—É–ª—ñ–Ω–∞—Ä—ñ—è|–ø–∏—Ç–∏
üêÄ	—â—É—Ä	–ø–∞—Ü—é–∫|—Ç–≤–∞—Ä–∏–Ω–∞|—â—É—Ä
üêÅ	–º–∏—à–∞	–º–∏—à–∞|—Ç–≤–∞—Ä–∏–Ω–∞
üêÇ	–±–∏–∫	–±–∏–∫|–≤—ñ–ª|–∑–æ–¥—ñ–∞–∫|—Ç–≤–∞—Ä–∏–Ω–∞|—Ç–µ–ª–µ—Ü—å
üêÉ	–±—É–π–≤—ñ–ª	–±—É–π–≤—ñ–ª|—Ç–≤–∞—Ä–∏–Ω–∞
üêÑ	–∫–æ—Ä–æ–≤–∞	–º–æ–ª–æ–∫–æ|–º—É|—Ç–≤–∞—Ä–∏–Ω–∞|—Ñ–µ—Ä–º–∞
üêÖ	—Ç–∏–≥—Ä	—Ç–≤–∞—Ä–∏–Ω–∞|—Ç–∏–≥—Ä|—Ö–∏–∂–∞–∫
üêÜ	–ª–µ–æ–ø–∞—Ä–¥	–¥–∏–∫–∞ –∫—ñ—à–∫–∞|–ª–µ–æ–ø–∞—Ä–¥|—Ç–≤–∞—Ä–∏–Ω–∞|—Ö–∏–∂–∞–∫
üêá	–∫—Ä–æ–ª–∏–∫	–∑–∞—î—Ü—å|–∫—Ä—ñ–ª—å|–∫—Ä–æ–ª–∏–∫|—Ç–≤–∞—Ä–∏–Ω–∞
üêà	–∫—ñ—Ç	–¥–æ–º–∞—à–Ω—ñ–π —É–ª—é–±–ª–µ–Ω–µ—Ü—å|–∫—ñ—Ç|–∫–æ—à–∞|—Ç–≤–∞—Ä–∏–Ω–∞
üêà‚Äç‚¨õ	—á–æ—Ä–Ω–∏–π –∫—ñ—Ç	–∫—ñ—Ç|–∫—ñ—à–∫–∞|–º—è—É|–Ω–µ–≤–¥–∞—Ö–∞|–Ω–µ–≤–¥–∞—á–∞|–Ω–µ—â–∞—Å—Ç—è|–ø–æ–≥–∞–Ω–∞ –ø—Ä–∏–∫–º–µ—Ç–∞|—Ç–≤–∞—Ä–∏–Ω–∞|—á–æ—Ä–Ω–∏–π
üêâ	–¥—Ä–∞–∫–æ–Ω	–¥—Ä–∞–∫–æ–Ω|–∫–∞–∑–∫–∞
üêä	–∫—Ä–æ–∫–æ–¥–∏–ª	–∞–ª—ñ–≥–∞—Ç–æ—Ä|–∫—Ä–æ–∫–æ–¥–∏–ª|—Ç–≤–∞—Ä–∏–Ω–∞|—Ö–∏–∂–∞–∫
üêã	–∫–∏—Ç	–∫–∏—Ç
üêå	—Ä–∞–≤–ª–∏–∫	–ø–∞–≤–ª–∏–∫-—Ä–∞–≤–ª–∏–∫|–ø–µ—Ç—Ä–∏–∫|–ø—Ä–∏—Ä–æ–¥–∞|—Ä–∞–≤–ª–∏–∫|—Å–ª–∏–º–∞–∫|—Ç–≤–∞—Ä–∏–Ω–∞
üêç	–∑–º—ñ—è	–≥–∞–¥—é–∫–∞|–∑–º—ñ—î–Ω–æ—Å–µ—Ü—å|–∑–º—ñ–π|–∑–º—ñ—è|–∑–æ–¥—ñ–∞–∫
üêé	–∫—ñ–Ω—å	–≤–µ—Ä—Ö–æ–≥–æ–Ω–∏|–∫—ñ–Ω–Ω—ñ|–∫—ñ–Ω—å|–ø–µ—Ä–µ–≥–æ–Ω–∏|—Å–∫–∞—á–∫–∏|—Ç–≤–∞—Ä–∏–Ω–∞
üêè	–±–∞—Ä–∞–Ω	–±–∞—Ä–∞–Ω|–≤—ñ–≤—Ü—è|–≥–æ—Ä–æ—Å–∫–æ–ø|–∑–æ–¥—ñ–∞–∫|–æ–≤–µ–Ω|—Ç–≤–∞—Ä–∏–Ω–∞
üêê	—Ü–∞–ø	–≥–æ—Ä–æ—Å–∫–æ–ø|–∑–æ–¥—ñ–∞–∫|–∫–æ–∑–µ–ª|–∫–æ–∑–µ—Ä—ñ–≥|—Ç–≤–∞—Ä–∏–Ω–∞|—Ü–∞–ø
üêë	–≤—ñ–≤—Ü—è	–≤—ñ–≤—Ü—è|–≤–æ–≤–Ω–∞|—Ç–≤–∞—Ä–∏–Ω–∞|—Ñ–µ—Ä–º–∞|—è–≥–Ω—è
üêí	–º–∞–≤–ø–∞	–º–∞–≤–ø–∞|—Ç–≤–∞—Ä–∏–Ω–∞
üêì	–ø—ñ–≤–µ–Ω—å	–∫–æ–≥—É—Ç|–ø—ñ–≤–µ–Ω—å|–ø—Ç–∞—Ö
üêî	–∫—É—Ä–∫–∞	–∫–≤–æ—á–∫–∞|–∫—É—Ä–∫–∞|–∫—É—Ä—á–∞|–ø—Ç–∞—Ö
üêï	—Å–æ–±–∞–∫–∞	–¥–æ–º–∞—à–Ω—è —Ç–≤–∞—Ä–∏–Ω–∞|–ø–µ—Å|—Å–æ–±–∞–∫–∞|—Ç–≤–∞—Ä–∏–Ω–∞
üêï‚Äçü¶∫	—Å–ª—É–∂–±–æ–≤–∏–π —Å–æ–±–∞–∫–∞	–¥–æ–ø–æ–º–æ–≥–∞|–¥–æ—Å—Ç—É–ø–Ω—ñ—Å—Ç—å|—Å–ª—É–∂–±–æ–≤–∏–π|—Å–æ–±–∞–∫–∞|—Å–ø–µ—Ü—ñ–∞–ª—å–Ω—ñ –º–æ–∂–ª–∏–≤–æ—Å—Ç—ñ|—Å—É–ø—Ä–æ–≤—ñ–¥|—Ç–≤–∞—Ä–∏–Ω–∞
üêñ	—Å–≤–∏–Ω—è	–ª—å–æ—Ö–∞|–ø–æ—Ä–æ—Å—è|—Å–≤–∏–Ω–æ–º–∞—Ç–∫–∞|—Å–≤–∏–Ω—è|—Ç–≤–∞—Ä–∏–Ω–∞
üêó	–≤–µ–ø—Ä	–≤–µ–ø—Ä|–∫–∞–±–∞–Ω|–∫–Ω—É—Ä|—Ç–≤–∞—Ä–∏–Ω–∞
üêò	—Å–ª–æ–Ω	—Å–ª–æ–Ω|—Ç–≤–∞—Ä–∏–Ω–∞
üêô	–≤–æ—Å—å–º–∏–Ω—ñ–≥	–≤–æ—Å—å–º–∏–Ω—ñ–≥
üêö	–º–æ—Ä—Å—å–∫–∞ –º—É—à–ª—è	–º–æ—Ä—Å—å–∫–∞ –º—É—à–ª—è|–º—É—à–ª—è|—Å–ø—ñ—Ä–∞–ª—å–Ω–∞ –º—É—à–ª—è|—Å–ø—ñ—Ä–∞–ª—å–Ω–∏–π
üêõ	–∫–æ–º–∞—Ö–∞	–≥—É—Å—ñ–Ω—å|–∫–æ–º–∞—Ö–∞|–∫–æ–º–∞—à–∏–Ω–∞|–∫–æ–º–∞—à–∫–∞
üêú	–º—É—Ä–∞—Ö–∞	–∫–æ–º–∞—Ö–∞|–º—É—Ä–∞—Ö–∞
üêù	–±–¥–∂–æ–ª–∞	–±–¥–∂–æ–ª–∞|–∫–æ–º–∞—Ö–∞
üêû	—Å–æ–Ω–µ—á–∫–æ	–∂—É—á–æ–∫|–∫–æ–º–∞—Ö–∞|–∫–æ—Ä—ñ–≤–∫–∞|—Å–æ–Ω–µ—á–∫–æ
üêü	—Ä–∏–±–∞	–≥–æ—Ä–æ—Å–∫–æ–ø|–∑–æ–¥—ñ–∞–∫|—Ä–∏–±–∞|—Ä–∏–±–∏
üê†	—Ç—Ä–æ–ø—ñ—á–Ω–∞ —Ä–∏–±–∞	–º–æ—Ä–µ|–æ–∫–µ–∞–Ω|—Ä–∏–±–∞|—Ç—Ä–æ–ø—ñ—á–Ω–∞ —Ä–∏–±–∞|—Ç—Ä–æ–ø—ñ—á–Ω–∏–π
üê°	—Ä–∏–±–∞-–∫—É–ª—è	—Ä–∏–±–∞|—Ä–∏–±–∞-—ó–∂–∞–∫|—Ä–∏–±–∞-–∫—É–ª—è
üê¢	—á–µ—Ä–µ–ø–∞—Ö–∞	—Ç–≤–∞—Ä–∏–Ω–∞|—á–µ—Ä–µ–ø–∞—Ö–∞
üê£	–∫—É—Ä—á–∞, —â–æ –≤–∏–ª—É–ø–ª—é—î—Ç—å—Å—è	–í–µ–ª–∏–∫–¥–µ–Ω—å|–≤–∏–ª—É–ø–ª—é–≤–∞—Ç–∏—Å—è|–∫—É—Ä—á–∞|–∫—É—Ä—á–∞, —â–æ –≤–∏–ª—É–ø–ª—é—î—Ç—å—Å—è|–Ω–æ–≤–æ–Ω–∞—Ä–æ–¥–∂–µ–Ω–∏–π|–ø—Ä–æ–∫–ª—å–æ–≤—É–≤–∞—Ç–∏—Å—è|–ø—Ç–∞—Ö|–ø—Ç–∞—à–∫–∞|—â–æ –≤–∏–ª—É–ø–ª—é—î—Ç—å—Å—è
üê§	–º–∞–ª–µ –∫—É—Ä—á–∞	–∫—É—Ä–∫–∞|–∫—É—Ä—á–∞|–∫—É—Ä—á–∞—Ç–∫–æ|–º–∞–ª–µ –∫—É—Ä—á–∞
üê•	–∫—É—Ä—á–∞, —â–æ —Å—Ç–æ—ó—Ç—å	–∞–Ω—Ñ–∞—Å|–∫—É—Ä—á–∞|–æ—Ä–Ω—ñ—Ç–æ–ª–æ–≥—ñ—è|–ø–∏—Å–∫–ª—è|–ø—Ç–∞—à–∞|–ø—Ç–∞—à–∫–∞|—Ç–≤–∞—Ä–∏–Ω–∞
üê¶	–ø—Ç–∞—Ö	–ø—Ç–∞—Ö|–ø—Ç–∞—à–∫–∞
üê¶‚Äç‚¨õ	—á–æ—Ä–Ω–∏–π –ø—Ç–∞—Ö	–≤–æ—Ä–æ–Ω|–¥–∑—å–æ–±|–¥—Ä—ñ–∑–¥|–∫–∞—Ä–∫–∞—Ç–∏|–∫—Ä—É–∫|–ø—Ç–∞—Ö|—Ç–≤–∞—Ä–∏–Ω–∞|—á–æ—Ä–Ω–∏–π
üê¶‚Äçüî•	—Ñ–µ–Ω—ñ–∫—Å	–≤—ñ–¥—Ä–æ–¥–∂–µ–Ω–Ω—è|–∂–∞—Ä-–ø—Ç–∏—Ü—è|–Ω–æ–≤–µ –∂–∏—Ç—Ç—è|–æ–∂–∏–≤–ª–µ–Ω–Ω—è|–æ–∂–∏—Ç–∏|–æ–Ω–æ–≤–ª–µ–Ω–Ω—è|–ø–µ—Ä–µ–≤—Ç—ñ–ª–µ–Ω–Ω—è|–ø–æ–≤—Å—Ç–∞—Ç–∏|—Å–ª–∞–≤–∞|—Ñ–∞–Ω—Ç–∞—Å—Ç–∏–∫–∞|—Ñ–µ–Ω—ñ–∫—Å
üêß	–ø—ñ–Ω–≥–≤—ñ–Ω	–ø—ñ–Ω–≥–≤—ñ–Ω|–ø—Ç–∞—Ö
üê®	–∫–æ–∞–ª–∞	–≤–µ–¥–º—ñ–¥—å|–º–æ—Ä–¥–∞|—Ç–≤–∞—Ä–∏–Ω–∞
üê©	–ø—É–¥–µ–ª—å	–ø–µ—Å|–ø—É–¥–µ–ª—å|—Å–æ–±–∞–∫–∞|—Ç–≤–∞—Ä–∏–Ω–∞
üê™	–æ–¥–Ω–æ–≥–æ—Ä–±–∏–π –≤–µ—Ä–±–ª—é–¥	–≤–µ—Ä–±–ª—é–¥|–≥–æ—Ä–±|–¥—Ä–æ–º–∞–¥–µ—Ä|–æ–¥–Ω–æ–≥–æ—Ä–±–∏–π|–ø—É—Å—Ç–µ–ª—è|–°–∞—Ö–∞—Ä–∞|—Ç–≤–∞—Ä–∏–Ω–∞
üê´	–¥–≤–æ–≥–æ—Ä–±–∏–π –≤–µ—Ä–±–ª—é–¥	–±–∞–∫—Ç—Ä—ñ–∞–Ω|–≤–µ—Ä–±–ª—é–¥|–≥–æ—Ä–±|–¥–≤–æ–≥–æ—Ä–±–∏–π|–∫–∞—Ä–∞–≤–∞–Ω|–ø—É—Å—Ç–µ–ª—è|—Ç–≤–∞—Ä–∏–Ω–∞
üê¨	–¥–µ–ª—å—Ñ—ñ–Ω	–¥–µ–ª—å—Ñ—ñ–Ω|–ø–ª–∞–≤–µ—Ü—å
üê≠	–º–æ—Ä–¥–∞ –º–∏—à—ñ	–º–∏—à–∞|–º–∏—à–∞—á–∞ –º–æ—Ä–¥–∞|–º–æ—Ä–¥–∞|–º–æ—Ä–¥–∞ –º–∏—à—ñ|–ø–∞—Ü—é–∫|—Ç–≤–∞—Ä–∏–Ω–∞
üêÆ	–º–æ—Ä–¥–∞ –∫–æ—Ä–æ–≤–∏	–∫–æ—Ä–æ–≤‚Äô—è—á–∞ –º–æ—Ä–¥–∞|–∫–æ—Ä–æ–≤ º—è—á–∞ –º–æ—Ä–¥–∞|–∫–æ—Ä–æ–≤–∞|–º–æ—Ä–¥–∞|–º–æ—Ä–¥–∞ –∫–æ—Ä–æ–≤–∏|—Ç–≤–∞—Ä–∏–Ω–∞
üêØ	–º–æ—Ä–¥–∞ —Ç–∏–≥—Ä–∞	–º–æ—Ä–¥–∞|–º–æ—Ä–¥–∞ —Ç–∏–≥—Ä–∞|—Ç–≤–∞—Ä–∏–Ω–∞|—Ç–∏–≥—Ä|—Ç–∏–≥—Ä—è—á–∞ –º–æ—Ä–¥–∞|—Ö–∏–∂–∞–∫
üê∞	–º–æ—Ä–¥–∞ –∫—Ä–æ–ª—è	–∑–∞—î—Ü—å|–∫—Ä–æ–ª–∏–∫|–∫—Ä–æ–ª—è—á–∞ –º–æ—Ä–¥–∞|–º–æ—Ä–¥–∞|–º–æ—Ä–¥–∞ –∫—Ä–æ–ª—è|—Ç–≤–∞—Ä–∏–Ω–∞
üê±	–º–æ—Ä–¥–∞ –∫–æ—Ç–∞	–¥–æ–º–∞—à–Ω—è —Ç–≤–∞—Ä–∏–Ω–∞|–∫—ñ—Ç|–∫–æ—Ç—è—á–∞ –º–æ—Ä–¥–∞|–º–æ—Ä–¥–∞|–º–æ—Ä–¥–∞ –∫–æ—Ç–∞|—Ç–≤–∞—Ä–∏–Ω–∞
üê≤	–≥–æ–ª–æ–≤–∞ –¥—Ä–∞–∫–æ–Ω–∞	–≥–æ–ª–æ–≤–∞|–≥–æ–ª–æ–≤–∞ –¥—Ä–∞–∫–æ–Ω–∞|–¥—Ä–∞–∫–æ–Ω|–∑–µ–ª–µ–Ω–∏–π –¥—Ä–∞–∫–æ–Ω|–∫–∞–∑–∫–∞
üê≥	–∫–∏—Ç, —â–æ –ø—É—Å–∫–∞—î —Ñ–æ–Ω—Ç–∞–Ω	–∫–∏—Ç|–æ–±–ª–∏—á—á—è|–æ–∫–µ–∞–Ω|–ø–ª—è–∂|—Ç–≤–∞—Ä–∏–Ω–∞|—Ñ–æ–Ω—Ç–∞–Ω
üê¥	–≥–æ–ª–æ–≤–∞ –∫–æ–Ω—è	–≥–æ–ª–æ–≤–∞ –∫–æ–Ω—è|–∫—ñ–Ω—å|–∫–æ–±–∏–ª–∞|–ª–æ—à–∞|–º–æ—Ä–¥–∞|—Ç–≤–∞—Ä–∏–Ω–∞
üêµ	–º–æ—Ä–¥–∞ –º–∞–≤–ø–∏	–º–∞–≤–ø–∞|–º–∞–≤–ø—è—á–∞ –º–æ—Ä–¥–∞|–º–æ—Ä–¥–∞|–º–æ—Ä–¥–∞ –º–∞–≤–ø–∏|—Ç–≤–∞—Ä–∏–Ω–∞
üê∂	–º–æ—Ä–¥–∞ —Å–æ–±–∞–∫–∏	–º–æ—Ä–¥–∞|–º–æ—Ä–¥–∞ —Å–æ–±–∞–∫–∏|–ø–µ—Å|—Å–æ–±–∞–∫–∞|—Å–æ–±–∞—á–∞ –º–æ—Ä–¥–∞|—Ç–≤–∞—Ä–∏–Ω–∞
üê∑	—Ä–∏–ª–æ —Å–≤–∏–Ω—ñ	–º–æ—Ä–¥–∞|–ø–æ—Ä–æ—Å—è|—Ä–∏–ª–æ —Å–≤–∏–Ω—ñ|—Å–≤–∏–Ω—è|—Å–≤–∏–Ω—è—á–µ —Ä–∏–ª–æ|—Ç–≤–∞—Ä–∏–Ω–∞
üê∏	–∂–∞–±–∞	–±–æ–ª–æ—Ç–æ|–∂–∞–± º—è—á–∞|–∂–∞–±–∞|–∂–∞–±–∏–Ω–∞|–º–æ—Ä–¥–∞|—Ç–≤–∞—Ä–∏–Ω–∞
üêπ	—Ö–æ–º º—è–∫	–¥–æ–º–∞—à–Ω—è —Ç–≤–∞—Ä–∏–Ω–∞|–º–æ—Ä–¥–∞|–º–æ—Ä–¥–∞ —Ö–æ–º‚Äô—è–∫–∞|—Ç–≤–∞—Ä–∏–Ω–∞|—Ö–æ–º‚Äô—è–∫|—Ö–æ–º‚Äô—è–∫–æ–≤–∞|—Ö–æ–º º—è–∫
üê∫	–≤–æ–≤–∫	–≤–æ–≤–∫|–≤–æ–≤—á–∞|–º–æ—Ä–¥–∞|—Ç–≤–∞—Ä–∏–Ω–∞|—Ö–∏–∂–∞–∫
üêª	–≤–µ–¥–º—ñ–¥—å	–≤–µ–¥–º–µ–¥–µ–≤–∞|–≤–µ–¥–º–µ–∂–∞|–≤–µ–¥–º–µ–∂–∞—á–∞|–≤–µ–¥–º—ñ–¥—å|–º–æ—Ä–¥–∞|—Ç–≤–∞—Ä–∏–Ω–∞
üêº	–ø–∞–Ω–¥–∞	–º–æ—Ä–¥–∞|–º–æ—Ä–¥–∞ –ø–∞–Ω–¥–∏|–ø–∞–Ω–¥–∞|—Ç–≤–∞—Ä–∏–Ω–∞
üêΩ	—Å–≤–∏–Ω—è—á–∏–π –ø º—è—Ç–∞–∫	–º–æ—Ä–¥–∞|—Ä–∏–ª–æ|—Å–≤–∏–Ω—è|—Å–≤–∏–Ω—è—á–µ —Ä–∏–ª—å—Ü–µ|—Å–≤–∏–Ω—è—á–∏–π –ø º—è—Ç–∞–∫
üêæ	—Å–ª—ñ–¥–∏ –ª–∞–ø	–≤—ñ–¥–±–∏—Ç–∫–∏ –ª–∞–ø|–ª–∞–ø–∞|—Å–ª—ñ–¥|—Å–ª—ñ–¥–∏ –ª–∞–ø
üëÄ	–æ—á—ñ	–æ–±–ª–∏—á—á—è|–æ–∫–æ|–æ—á—ñ|—Ç—ñ–ª–æ
üëÇ	–≤—É—Ö–æ	–≤—É—Ö–æ|—Å–ª—É—Ö–∞—Ç–∏|—Å–ª—É—Ö–∞—é|—Ç—ñ–ª–æ
üëÉ	–Ω—ñ—Å	–Ω—ñ—Å|—Ç—ñ–ª–æ
üëÑ	—Ä–æ—Ç	–≥—É–±–∏|–ø–æ–º–∞–¥–∞|–ø–æ—Ü—ñ–ª—É–Ω–æ–∫|—Ä–æ—Ç|—Ç—ñ–ª–æ|—á—É—Ç–ª–∏–≤–∞
üëÖ	—è–∑–∏–∫	—Ç—ñ–ª–æ|—è–∑–∏–∫
üëÜ	–ø–∞–ª–µ—Ü—å —Ç–∏–ª—å–Ω–∏–º –±–æ–∫–æ–º, —â–æ –≤–∫–∞–∑—É—î –≤–≥–æ—Ä—É	–≤–∫–∞–∑—ñ–≤–Ω–∏–π|–ø–∞–ª–µ—Ü—å|–ø–∞–ª–µ—Ü—å —Ç–∏–ª—å–Ω–∏–º –±–æ–∫–æ–º|–ø–∞–ª–µ—Ü—å —Ç–∏–ª—å–Ω–∏–º –±–æ–∫–æ–º, —â–æ –≤–∫–∞–∑—É—î –≤–≥–æ—Ä—É|–ø–æ–∫–∞–∑—É–≤–∞—Ç–∏|—Ä—É–∫–∞|—É–≥–æ—Ä—É|—É–∫–∞–∑—É–≤–∞—Ç–∏|—â–æ –≤–∫–∞–∑—É—î –≤–≥–æ—Ä—É
üëá	–ø–∞–ª–µ—Ü—å —Ç–∏–ª—å–Ω–∏–º –±–æ–∫–æ–º, —â–æ –≤–∫–∞–∑—É—î –≤–Ω–∏–∑	–≤–∫–∞–∑—ñ–≤–Ω–∏–π|–¥–∏–≤–∏—Å—å –Ω–∏–∂—á–µ|–ø–∞–ª–µ—Ü—å|–ø–∞–ª–µ—Ü—å —Ç–∏–ª—å–Ω–∏–º –±–æ–∫–æ–º|–ø–∞–ª–µ—Ü—å —Ç–∏–ª—å–Ω–∏–º –±–æ–∫–æ–º, —â–æ –≤–∫–∞–∑—É—î –≤–Ω–∏–∑|—Ä—É–∫–∞|—Ç–∏–ª—å–Ω–∏–π|—É–∫–∞–∑—É–≤–∞—Ç–∏|—É–Ω–∏–∑|—â–æ –≤–∫–∞–∑—É—î –≤–Ω–∏–∑
üëà	–ø–∞–ª–µ—Ü—å —Ç–∏–ª—å–Ω–∏–º –±–æ–∫–æ–º, —â–æ –≤–∫–∞–∑—É—î –≤–ª—ñ–≤–æ	–≤–ª—ñ–≤–æ|–ø–∞–ª–µ—Ü—å|–ø–æ–∫–∞–∑—É–≤–∞—Ç–∏|—Ä—É–∫–∞|—Ç–∏–ª—å–Ω–∏–π –±—ñ–∫|—â–æ –≤–∫–∞–∑—É—î
üëâ	–ø–∞–ª–µ—Ü—å —Ç–∏–ª—å–Ω–∏–º –±–æ–∫–æ–º, —â–æ –≤–∫–∞–∑—É—î –≤–ø—Ä–∞–≤–æ	–≤–∫–∞–∑—ñ–≤–Ω–∏–π|–ø–∞–ª–µ—Ü—å|–ø–∞–ª–µ—Ü—å —Ç–∏–ª—å–Ω–∏–º –±–æ–∫–æ–º|–ø–∞–ª–µ—Ü—å —Ç–∏–ª—å–Ω–∏–º –±–æ–∫–æ–º, —â–æ –≤–∫–∞–∑—É—î –≤–ø—Ä–∞–≤–æ|–ø–æ–∫–∞–∑—É–≤–∞—Ç–∏|—Ä—É–∫–∞|—É–∫–∞–∑—É–≤–∞—Ç–∏|—É–ø—Ä–∞–≤–æ|—â–æ –≤–∫–∞–∑—É—î –≤–ø—Ä–∞–≤–æ
üëä	–∫—É–ª–∞–∫, —â–æ –Ω–∞—Å—É–≤–∞—î—Ç—å—Å—è	–∞–±—Å–æ–ª—é—Ç–Ω–æ|–±—Ä–æ|–±—É–º|–∑–≥–æ–¥–∞|–∫—É–ª–∞–∫|–ø—Ä–∞–≤–∏–ª—å–Ω–æ|—Ä–æ–∫|—Ä—É–∫–∞|—Å—Ç–∏—Å–Ω—É—Ç–∏–π|—É–¥–∞—Ä
üëã	—Ä—É–∫–∞ –º–∞—Ö–∞—î	–±—É–≤–∞–π|–≤—ñ—Ç–∞–Ω–Ω—è|–≤—ñ—Ç–∞—é|–¥–∞–π –ø º—è—Ç—å|–¥–æ –∑—É—Å—Ç—Ä—ñ—á—ñ|–¥–æ–ª–æ–Ω—è|–º–∞—Ö–∞—Ç–∏|–ø–æ–º–∞—Ö|–ø—Ä–∏–≤—ñ—Ç|—Ä—É–∫–∞|—Ä—É–∫–∞ –º–∞—Ö–∞—î|—Ç—ñ–ª–æ
üëå	–∂–µ—Å—Ç ¬´–æ–∫–µ–π¬ª	–≥–∞—Ä–∞–∑–¥|–¥–æ–±—Ä–µ|–∂–µ—Å—Ç|–∑—Ä–æ–∑—É–º—ñ–ª–æ|–∫—Ä—É—Ç–æ|–æ‚Äô–∫–µ–π|—Ä—É–∫–∞|—Ç–∞–∫|—Ç—ñ–ª–æ|—á—É–¥–æ–≤–æ
üëç	–≤–µ–ª–∏–∫—ñ –ø–∞–ª—å—Ü—ñ –≤–≥–æ—Ä—É	+1|–≤–µ–ª–∏–∫—ñ –ø–∞–ª—å—Ü—ñ –≤–≥–æ—Ä—É|–≥–∞—Ä–∞–∑–¥|–¥–æ–±—Ä–µ|–¥–æ–º–æ–≤–∏–ª–∏—Å—è|–∫–ª–∞—Å–Ω–æ|–∫—Ä—É—Ç–æ|–ø–∞–ª–µ—Ü—å —É–≥–æ—Ä—É|–ø–æ–¥–æ–±–∞—î—Ç—å—Å—è|—Ä—É–∫–∞|—Å—É–ø–µ—Ä|—Å—Ö–≤–∞–ª–µ–Ω–Ω—è|—Ç–∞–∫|—Ç—ñ–ª–æ|—Ñ–∞–π–Ω–æ|—á—É–¥–æ–≤–æ
üëé	–≤–µ–ª–∏–∫—ñ –ø–∞–ª—å—Ü—ñ –≤–Ω–∏–∑	-1|–≤–µ–ª–∏–∫—ñ –ø–∞–ª—å—Ü—ñ –≤–Ω–∏–∑|–Ω–µ –ø–æ–¥–æ–±–∞—î—Ç—å—Å—è|–ø–∞–ª–µ—Ü—å —É–Ω–∏–∑|—Ä—É–∫–∞|—Ç—ñ–ª–æ
üëè	—Ä—É–∫–∏, —â–æ –∞–ø–ª–æ–¥—É—é—Ç—å	–∞–ø–ª–æ–¥–∏—Å–º–µ–Ω—Ç–∏|–±—ñ—Å|–±—Ä–∞–≤–æ|–≤—ñ–¥–º—ñ–Ω–Ω–æ|–≤—ñ—Ç–∞–Ω–Ω—è|–æ–ø–ª–µ—Å–∫–∏|–ø–ª–µ—Å–∫–∞—Ç–∏|—Ä—É–∫–∞|—É—Ä–∞|—á—É–¥–æ–≤–æ
üëê	–≤—ñ–¥–∫—Ä–∏—Ç—ñ –¥–æ–ª–æ–Ω—ñ	–≤—ñ–¥–∫—Ä–∏—Ç–∏–π|–≤—ñ–¥–∫—Ä–∏—Ç—ñ –¥–æ–ª–æ–Ω—ñ|–≤—ñ–¥–∫—Ä–∏—Ç—ñ —Ä—É–∫–∏|–¥–æ–ª–æ–Ω—ñ|—Ä—É–∫–∞|—Ç—ñ–ª–æ
üëë	–∫–æ—Ä–æ–Ω–∞	–≤–∞—à–∞ –≤–∏—Å–æ—á–Ω—ñ—Å—Ç—å|–∫–æ—Ä–æ–ª–µ–≤–∞|–∫–æ—Ä–æ–ª–µ–≤—Å—Ç–≤–æ|–∫–æ—Ä–æ–ª—å|–∫–æ—Ä–æ–Ω–∞|–æ–¥—è–≥
üëí	–∂—ñ–Ω–æ—á–∏–π –∫–∞–ø–µ–ª—é—à–æ–∫	–∂—ñ–Ω–∫–∞|–∂—ñ–Ω–æ—á–∏–π –∫–∞–ø–µ–ª—é—Ö|–∂—ñ–Ω–æ—á–∏–π –∫–∞–ø–µ–ª—é—à–æ–∫|–∫–∞–ø–µ–ª—é—Ö|–æ–¥—è–≥
üëì	–æ–∫—É–ª—è—Ä–∏	–æ–¥—è–≥|–æ–∫–æ|–æ–∫—É–ª—è—Ä–∏
üëî	–∫—Ä–∞–≤–∞—Ç–∫–∞	–∫—Ä–∞–≤–∞—Ç–∫–∞|–æ–¥—è–≥
üëï	—Ç–µ–Ω—ñ—Å–∫–∞ –ø–æ–ª–æ	–æ–¥—è–≥|—Ç–µ–Ω—ñ—Å–∫–∞|—Ç–µ–Ω—ñ—Å–∫–∞ –ø–æ–ª–æ|—Ç–æ–ø|—Ñ—É—Ç–±–æ–ª–∫–∞
üëñ	–¥–∂–∏–Ω—Å–∏	–¥–∂–∏–Ω—Å–∏|–æ–¥—è–≥|—à—Ç–∞–Ω–∏
üëó	—Å—É–∫–Ω—è	–æ–¥—è–≥|—Å—É–∫–Ω—è
üëò	–∫—ñ–º–æ–Ω–æ	–∫—ñ–º–æ–Ω–æ|–æ–¥—è–≥
üëô	–±—ñ–∫—ñ–Ω—ñ	–±—ñ–∫—ñ–Ω—ñ|–∫—É–ø–∞–ª—å–Ω–∏–∫|–æ–¥—è–≥|–ø–ª–∞–≤–∞—Ç–∏
üëö	–∂—ñ–Ω–æ—á–∏–π –æ–¥—è–≥	T-Shirt|–±–ª—É–∑–∞|–∂—ñ–Ω–∫–∞|–∂—ñ–Ω–æ—á–∏–π –æ–¥—è–≥|–æ–¥—è–≥|—Ç–æ–ø|—Ñ—É—Ç–±–æ–ª–∫–∞
üëõ	–≥–∞–º–∞–Ω–µ—Ü—å	–∞–∫—Å–µ—Å—É–∞—Ä|–≥–∞–º–∞–Ω–µ—Ü—å|–≥—Ä–æ—à—ñ|–º–æ–Ω–µ—Ç–∞|–æ–¥—è–≥
üëú	—Å—É–º–∫–∞	–æ–¥—è–≥|—Å—É–º–∫–∞
üëù	–∫–ª–∞—Ç—á	–∫–ª–∞—Ç—á|–æ–¥—è–≥|—Å—É–º–∫–∞
üëû	—á–æ–ª–æ–≤—ñ—á–∞ —Ç—É—Ñ–ª—è	–≤–∑—É—Ç—Ç—è|–æ–¥—è–≥|—Ç—É—Ñ–ª—ñ|—á–æ–ª–æ–≤—ñ–∫|—á–æ–ª–æ–≤—ñ—á–∞ —Ç—É—Ñ–ª—è|—á–æ–ª–æ–≤—ñ—á–µ –≤–∑—É—Ç—Ç—è
üëü	–∫—Ä–æ—Å—ñ–≤–∫–∞	–≤–∑—É—Ç—Ç—è|–≤–∑—É—Ç—Ç—è –¥–ª—è –±—ñ–≥—É|–∫—Ä–æ—Å—ñ–≤–∫–∞|–∫—Ä–æ—Å—ñ–≤–∫–∏|–∫—Ä–æ—Å—ñ–≤–æ–∫|–æ–¥—è–≥|—Å–ø–æ—Ä—Ç–∏–≤–Ω–∏–π
üë†	—Ç—É—Ñ–ª—è –Ω–∞ –≤–∏—Å–æ–∫–æ–º—É –ø—ñ–¥–±–æ—Ä—ñ	–≤–∑—É—Ç—Ç—è|–∂—ñ–Ω–∫–∞|–∫–∞–±–ª—É–∫|–æ–¥—è–≥|—Ç—É—Ñ–ª—ñ|—Ç—É—Ñ–ª—è –Ω–∞ –≤–∏—Å–æ–∫–æ–º—É –ø—ñ–¥–±–æ—Ä—ñ|—à–ø–∏–ª—å–∫–∞
üë°	–∂—ñ–Ω–æ—á–∞ —Å–∞–Ω–¥–∞–ª—ñ—è –∑ –ø—ñ–¥–±–æ—Ä–æ–º	–≤–∑—É—Ç—Ç—è|–∂—ñ–Ω–∫–∞|–∂—ñ–Ω–æ—á–∞ —Å–∞–Ω–¥–∞–ª—ñ—è –∑ –ø—ñ–¥–±–æ—Ä–æ–º|–∫–∞–±–ª—É–∫|–æ–¥—è–≥|—Å–∞–Ω–¥–∞–ª—ñ
üë¢	–∂—ñ–Ω–æ—á–∏–π —á–æ–±—ñ—Ç	–≤–∑—É—Ç—Ç—è|–∂—ñ–Ω–∫–∞|–∂—ñ–Ω–æ—á–∏–π —á–æ–±—ñ—Ç|–æ–¥—è–≥|—Ç–µ–ø–ª–µ –≤–∑—É—Ç—Ç—è|—á–æ–±—ñ—Ç
üë£	—Å–ª—ñ–¥–∏ –Ω—ñ–≥	–≤—ñ–¥–±–∏—Ç–∫–∏|–≤—ñ–¥–±–∏—Ç–æ–∫|–Ω–æ–≥–∞|–æ–¥—è–≥|—Å–ª—ñ–¥|—Å—Ç–æ–ø–∏|—Å—Ç—É–ø–Ω—ñ|—Ç—ñ–ª–æ
üë§	—Å–∏–ª—É–µ—Ç –±—é—Å—Ç—É –ª—é–¥–∏–Ω–∏	–±—é—Å—Ç|–∑–∞–≥–∞–¥–∫–∞|—ñ–Ω–∫–æ–≥–Ω—ñ—Ç–æ|—Ç–∞—î–º–Ω–∏—Ü—è|—Ç—ñ–Ω—å
üë•	—Å–∏–ª—É–µ—Ç–∏ –¥–≤–æ—Ö –ª—é–¥—Å—å–∫–∏—Ö –±—é—Å—Ç—ñ–≤	–±—é—Å—Ç|–ª—é–¥–∏|—Å–∏–ª—É–µ—Ç|—Å–∏–ª—É–µ—Ç–∏ –¥–≤–æ—Ö –ª—é–¥—Å—å–∫–∏—Ö –±—é—Å—Ç—ñ–≤
üë¶	—Ö–ª–æ–ø—á–∏–∫	–ª—é–¥–∏–Ω–∞|–º–∞–ª–µ—á–∞|—Ö–ª–æ–ø–µ—Ü—å|—Ö–ª–æ–ø—á–∏–∫
üëß	–¥—ñ–≤—á–∏–Ω–∫–∞	–¥—ñ–≤–∞|–¥—ñ–≤—á–∏–Ω–∞|–¥—ñ–≤—á–∏–Ω–∫–∞|–∑–æ–¥—ñ–∞–∫|—Ö–≤–æ—Å—Ç–∏–∫–∏|—à–∫—ñ–ª—å–Ω–∏—Ü—è
üë®	—á–æ–ª–æ–≤—ñ–∫	–±–ª–æ–Ω–¥–∏–Ω|–¥–æ—Ä–æ—Å–ª–∏–π|–ª—é–¥–∏–Ω–∞|—á–æ–ª–æ–≤—ñ–∫
üë®‚Äçüåæ	—Ñ–µ—Ä–º–µ—Ä	–≥–æ—Å–ø–æ–¥–∞—Ä|—Å–∞–¥—ñ–≤–Ω–∏–∫|—Ñ–µ—Ä–º–µ—Ä|—á–æ–ª–æ–≤—ñ–∫
üë®‚Äçüç≥	–∫—É—Ö–∞—Ä	–∫—É–ª—ñ–Ω–∞—Ä|–∫—É—Ö–∞—Ä|—Ä–æ–±–æ—Ç–∞|—á–æ–ª–æ–≤—ñ–∫|—á–æ–ª–æ–≤—ñ–∫-–∫—É—Ö–∞—Ä|—à–µ–≤-–ø–æ–≤–∞—Ä|—à–µ—Ñ-–∫—É—Ö–∞—Ä
üë®‚Äçüçº	—á–æ–ª–æ–≤—ñ–∫ –≥–æ–¥—É—î –¥–∏—Ç–∏–Ω—É	–±–∞—Ç—å–∫—ñ–≤—Å—Ç–≤–æ|–±–∞—Ç—å–∫–æ|–≥–æ–¥—É–≤–∞–Ω–Ω—è|–¥–∏—Ç–∏–Ω–∞|–¥–æ–≥–ª—è–¥|–ª—é–¥–∏–Ω–∞|–Ω–µ–º–æ–≤–ª—è|–Ω—è–Ω—å—á–∏—Ç–∏|—Ç–∞—Ç–æ|—Ç—É—Ä–±–æ—Ç–∞|—á–æ–ª–æ–≤—ñ–∫|—á–æ–ª–æ–≤—ñ–∫ –≥–æ–¥—É—î –¥–∏—Ç–∏–Ω—É
üë®‚Äçüéì	—Å—Ç—É–¥–µ–Ω—Ç	–∞–±—ñ—Ç—É—Ä—ñ—î–Ω—Ç|–±–æ–Ω–µ—Ç|–≤–∏–ø—É—Å–∫–Ω–∏–∫|—Å—Ç—É–¥–µ–Ω—Ç|—á–æ–ª–æ–≤—ñ–∫
üë®‚Äçüé§	—Å–ø—ñ–≤–∞–∫	–∞—Ä—Ç–∏—Å—Ç|–≤–∏–∫–æ–Ω–∞–≤–µ—Ü—å|–∑—ñ—Ä–∫–∞|–ª—é–¥–∏–Ω–∞|–ø—ñ—Å–Ω—è—Ä|—Ä–æ–∫|—Å–æ–ª—ñ—Å—Ç|—Å–ø—ñ–≤–∞–∫|—á–æ–ª–æ–≤—ñ–∫
üë®‚Äçüé®	—á–æ–ª–æ–≤—ñ–∫-—Ö—É–¥–æ–∂–Ω–∏–∫	–∂–∏–≤–æ–ø–∏—Å–µ—Ü—å|–º–∞–ª—è—Ä|–º–∏—Ç–µ—Ü—å|–ø–∞–ª—ñ—Ç—Ä–∞|–ø–µ–Ω–∑–ª–∏–∫–∏|—Ä–æ–±–æ—Ç–∞|—Ç–≤–æ—Ä–µ—Ü—å|—Ö—É–¥–æ–∂–Ω–∏–∫|—á–æ–ª–æ–≤—ñ–∫-—Ö—É–¥–æ–∂–Ω–∏–∫
üë®‚Äçüè´	—É—á–∏—Ç–µ–ª—å	–≤–∏–∫–ª–∞–¥–∞—á|–≤—á–∏—Ç–µ–ª—å|—ñ–Ω—Å—Ç—Ä—É–∫—Ç–æ—Ä|–ø—Ä–æ—Ñ–µ—Å–æ—Ä|—Ä–æ–±–æ—Ç–∞|—É—á–∏—Ç–µ–ª—å|—á–æ–ª–æ–≤—ñ–∫
üë®‚Äçüè≠	—Ä–æ–±—ñ—Ç–Ω–∏–∫	–∑–∞–≤–æ–¥|–∫–æ–Ω–≤–µ—î—Ä|–ø—Ä–æ–º–∏—Å–ª–æ–≤–∏–π|—Ä–æ–±—ñ—Ç–Ω–∏–∫|—Ç—Ä—É–¥—ñ–≤–Ω–∏–∫|—Ñ–∞–±—Ä–∏–∫–∞|—á–æ–ª–æ–≤—ñ–∫
üë®‚Äçüíª	—Ç–µ—Ö–Ω–æ–ª–æ–≥	–≤–∏–Ω–∞—Ö—ñ–¥–Ω–∏–∫|–∫–æ–¥—É–≤–∞–ª—å–Ω–∏–∫|–∫–æ–º–ø‚Äô—é—Ç–µ—Ä|–ø—Ä–æ–≥—Ä–∞–º—ñ—Å—Ç|—Ä–æ–±–æ—Ç–∞|—Ä–æ–∑—Ä–æ–±–Ω–∏–∫|—Ç–µ—Ö–Ω—ñ–∫-–ø—Ä–æ–≥—Ä–∞–º—ñ—Å—Ç|—Ç–µ—Ö–Ω–æ–ª–æ–≥|—á–æ–ª–æ–≤—ñ–∫
üë®‚Äçüíº	—Å–ª—É–∂–±–æ–≤–µ—Ü—å	–∞—Ä—Ö—ñ—Ç–µ–∫—Ç–æ—Ä|–º–µ–Ω–µ–¥–∂–µ—Ä|–æ—Ñ—ñ—Å|–æ—Ñ—ñ—Å–Ω–∏–π –ø—Ä–∞—Ü—ñ–≤–Ω–∏–∫|—Å–ª—É–∂–±–æ–≤–µ—Ü—å|—á–æ–ª–æ–≤—ñ–∫
üë®‚Äçüîß	–º–µ—Ö–∞–Ω—ñ–∫	–≤–æ–¥–æ–ø—Ä–æ–≤—ñ–¥–Ω–∏–∫|–µ–ª–µ–∫—Ç—Ä–∏–∫|–µ–ª–µ–∫—Ç—Ä–æ—Ç–µ—Ö–Ω—ñ–∫|–º–µ—Ö–∞–Ω—ñ–∫|—Ä–æ–±–æ—Ç–∞|—Å–∞–Ω—Ç–µ—Ö–Ω—ñ–∫|—Ñ–∞—Ö—ñ–≤–µ—Ü—å|—á–æ–ª–æ–≤—ñ–∫
üë®‚Äçüî¨	–Ω–∞—É–∫–æ–≤–µ—Ü—å	–±—ñ–æ–ª–æ–≥|—ñ–Ω–∂–µ–Ω–µ—Ä|–Ω–∞—É–∫–∞|–Ω–∞—É–∫–æ–≤–µ—Ü—å|—Ñ—ñ–∑–∏–∫|—Ö—ñ–º—ñ–∫|—á–æ–ª–æ–≤—ñ–∫
üë®‚ÄçüöÄ	–∞—Å—Ç—Ä–æ–Ω–∞–≤—Ç	–∞—Å—Ç—Ä–æ–Ω–∞–≤—Ç|–∫–æ—Å–º–æ–Ω–∞–≤—Ç|–∫–æ—Å–º–æ—Å|—Ä–∞–∫–µ—Ç–∞|—Ä–æ–±–æ—Ç–∞|—á–æ–ª–æ–≤—ñ–∫
üë®‚Äçüöí	–ø–æ–∂–µ–∂–Ω–∏–∫	–≤–æ–≥–Ω–µ–±–æ—Ä–µ—Ü—å|–ø–æ–∂–µ–∂–Ω–∏–π –∞–≤—Ç–æ–º–æ–±—ñ–ª—å|–ø–æ–∂–µ–∂–Ω–∏–∫|—Ä–æ–±–æ—Ç–∞|—á–æ–ª–æ–≤—ñ–∫
üë®‚Äçü¶Ø	—á–æ–ª–æ–≤—ñ–∫ —ñ–∑ —Ç–∞–∫—Ç–∏–ª—å–Ω–æ—é —Ç—Ä–æ—Å—Ç–∏–Ω–æ—é	–±—ñ–ª–∞|–±—ñ–ª–∏–π|–¥–æ—Å—Ç—É–ø–Ω—ñ—Å—Ç—å|–Ω–µ–∑—Ä—è—á–∏–π|—Å–ª—ñ–ø–∏–π|—Å–ø–µ—Ü—ñ–∞–ª—å–Ω—ñ –º–æ–∂–ª–∏–≤–æ—Å—Ç—ñ|—Ç—Ä–æ—Å—Ç–∏–Ω–∞|—Ü—ñ–ø–æ–∫|—á–æ–ª–æ–≤—ñ–∫
üë®‚Äçü¶º	—á–æ–ª–æ–≤—ñ–∫ —É –≤—ñ–∑–∫—É –∑ –µ–ª–µ–∫—Ç—Ä–æ–ø—Ä–∏–≤–æ–¥–æ–º	–≤—ñ–∑–æ–∫|–¥–æ—Å—Ç—É–ø–Ω—ñ—Å—Ç—å|–∫–æ–ª—ñ—Å–Ω–µ –∫—Ä—ñ—Å–ª–æ|–ª—é–¥–∏–Ω–∞|—Å–ø–µ—Ü—ñ–∞–ª—å–Ω—ñ –º–æ–∂–ª–∏–≤–æ—Å—Ç—ñ|—á–æ–ª–æ–≤—ñ–∫|—á–æ–ª–æ–≤—ñ–∫ —É –≤—ñ–∑–∫—É|—á–æ–ª–æ–≤—ñ–∫ —É –≤—ñ–∑–∫—É –∑ –µ–ª–µ–∫—Ç—Ä–æ–ø—Ä–∏–≤–æ–¥–æ–º
üë®‚Äçü¶Ω	—á–æ–ª–æ–≤—ñ–∫ —É –≤—ñ–∑–∫—É –∑ —Ä—É—á–Ω–∏–º –ø—Ä–∏–≤–æ–¥–æ–º	–≤—ñ–∑–æ–∫|–¥–æ—Å—Ç—É–ø–Ω—ñ—Å—Ç—å|–∫–æ–ª—ñ—Å–Ω–µ –∫—Ä—ñ—Å–ª–æ|—Å–ø–µ—Ü—ñ–∞–ª—å–Ω—ñ –º–æ–∂–ª–∏–≤–æ—Å—Ç—ñ|—á–æ–ª–æ–≤—ñ–∫|—á–æ–ª–æ–≤—ñ–∫ —É –≤—ñ–∑–∫—É|—á–æ–ª–æ–≤—ñ–∫ —É –≤—ñ–∑–∫—É –∑ —Ä—É—á–Ω–∏–º –ø—Ä–∏–≤–æ–¥–æ–º
üë©	–∂—ñ–Ω–∫–∞	–±—ñ–ª—è–≤–∫–∞|–¥–æ—Ä–æ—Å–ª–∞|–∂—ñ–Ω–∫–∞|–ª—é–¥–∏–Ω–∞
üë©‚Äçüåæ	—Ñ–µ—Ä–º–µ—Ä–∫–∞	–≥–æ—Å–ø–æ–¥–∞—Ä–∫–∞|–∂—ñ–Ω–∫–∞|—Ä–æ–±–æ—Ç–∞|—Å–∞–¥—ñ–≤–Ω–∏–∫|—Å–∞–¥—ñ–≤–Ω–∏—Ü—è|—Ñ–µ—Ä–º–µ—Ä|—Ñ–µ—Ä–º–µ—Ä–∫–∞
üë©‚Äçüç≥	–∫—É—Ö–∞—Ä–∫–∞	–∂—ñ–Ω–∫–∞|–∂—ñ–Ω–∫–∞-–∫—É—Ö–∞—Ä|–∫—É–ª—ñ–Ω–∞—Ä–∫–∞|–∫—É—Ö–∞—Ä|–∫—É—Ö–∞—Ä–∫–∞|–ø–æ–≤–∞—Ä|–ø–æ–≤–∞—Ä–∏—Ö–∞|—Ä–æ–±–æ—Ç–∞|—à–µ—Ñ-–∫—É—Ö–∞—Ä–∫–∞|—à–µ—Ñ-–ø–æ–≤–∞—Ä
üë©‚Äçüçº	–∂—ñ–Ω–∫–∞ –≥–æ–¥—É—î –¥–∏—Ç–∏–Ω—É	–±–∞—Ç—å–∫—ñ–≤—Å—Ç–≤–æ|–≥–æ–¥—É–≤–∞–Ω–Ω—è|–¥–∏—Ç–∏–Ω–∞|–¥–æ–≥–ª—è–¥|–∂—ñ–Ω–∫–∞|–∂—ñ–Ω–∫–∞ –≥–æ–¥—É—î –¥–∏—Ç–∏–Ω—É|–ª—é–¥–∏–Ω–∞|–º–∞–º–∞|–º–∞—Ç–µ—Ä–∏–Ω—Å—Ç–≤–æ|–º–∞—Ç–∏|–º–∞—Ç—É—Å—è|–Ω–µ–º–æ–≤–ª—è
üë©‚Äçüéì	—Å—Ç—É–¥–µ–Ω—Ç–∫–∞	–∞–±—ñ—Ç—É—Ä—ñ—î–Ω—Ç–∫–∞|–±–æ–Ω–µ—Ç|–≤–∏–ø—É—Å–∫–Ω–∏—Ü—è|–∂—ñ–Ω–∫–∞|—Å—Ç—É–¥–µ–Ω—Ç–∫–∞
üë©‚Äçüé§	—Å–ø—ñ–≤–∞—á–∫–∞	–∞—Ä—Ç–∏—Å—Ç–∫–∞|–≤–∏–∫–æ–Ω–∞–≤–∏—Ü—è|–∂—ñ–Ω–∫–∞|–∑—ñ—Ä–∫–∞|–ª—é–¥–∏–Ω–∞|—Ä–æ–∫|—Å–æ–ª—ñ—Å—Ç–∫–∞|—Å–ø—ñ–≤–∞—á–∫–∞
üë©‚Äçüé®	—Ö—É–¥–æ–∂–Ω–∏—Ü—è	–∂—ñ–Ω–∫–∞-–º–∏—Ç–µ—Ü—å|–º–∞–ª—è—Ä–∫–∞|–ø–∞–ª—ñ—Ç—Ä–∞|–ø–µ–Ω–∑–ª–∏–∫–∏|—Ä–æ–±–æ—Ç–∞|—Ö—É–¥–æ–∂–Ω–∏—Ü—è
üë©‚Äçüè´	—É—á–∏—Ç–µ–ª—å–∫–∞	–≤–∏–∫–ª–∞–¥–∞—á–∫–∞|–≤—á–∏—Ç–µ–ª—å–∫–∞|–∂—ñ–Ω–∫–∞|—ñ–Ω—Å—Ç—Ä—É–∫—Ç–æ—Ä|–ø—Ä–æ—Ñ–µ—Å–æ—Ä|—Ä–æ–±–æ—Ç–∞|—É—á–∏—Ç–µ–ª—å–∫–∞
üë©‚Äçüè≠	—Ä–æ–±—ñ—Ç–Ω–∏—Ü—è	–∂—ñ–Ω–∫–∞|–∑–∞–≤–æ–¥|–∑–≤–∞—Ä–∫–∞|–∫–æ–Ω–≤–µ—î—Ä|–º–æ–Ω—Ç–∞–∂|–ø—Ä–æ–º–∏—Å–ª–æ–≤–∏–π|—Ä–æ–±—ñ—Ç–Ω–∏–∫|—Ä–æ–±—ñ—Ç–Ω–∏—Ü—è|—Ç—Ä—É–¥—ñ–≤–Ω–∏—Ü—è|—Ñ–∞–±—Ä–∏–∫–∞
üë©‚Äçüíª	–∂—ñ–Ω–∫–∞-—Ç–µ—Ö–Ω–æ–ª–æ–≥	–≤–∏–Ω–∞—Ö—ñ–¥–Ω–∏—Ü—è|–∂—ñ–Ω–∫–∞|–∂—ñ–Ω–∫–∞-–ø—Ä–æ–≥—Ä–∞–º—ñ—Å—Ç|–∂—ñ–Ω–∫–∞-—Ç–µ—Ö–Ω–æ–ª–æ–≥|–∫–æ–¥—É–≤–∞–ª—å–Ω–∏—Ü—è|–æ—Ñ—ñ—Å–Ω–∞ –ø—Ä–∞—Ü—ñ–≤–Ω–∏—Ü—è|—Ä–æ–±–æ—Ç–∞|—Ç–µ—Ö–Ω—ñ–∫-–ø—Ä–æ–≥—Ä–∞–º—ñ—Å—Ç
üë©‚Äçüíº	—Å–ª—É–∂–±–æ–≤–∫–∞	–∞—Ä—Ö—ñ—Ç–µ–∫—Ç–æ—Ä|–¥—ñ–ª–æ–≤–∞ –∂—ñ–Ω–∫–∞|–∂—ñ–Ω–∫–∞|–º–µ–Ω–µ–¥–∂–µ—Ä|–æ—Ñ—ñ—Å|–æ—Ñ—ñ—Å–Ω–∞ –ø—Ä–∞—Ü—ñ–≤–Ω–∏—Ü—è|—Å–ª—É–∂–±–æ–≤–∫–∞
üë©‚Äçüîß	–∂—ñ–Ω–∫–∞-–º–µ—Ö–∞–Ω—ñ–∫	–∂—ñ–Ω–∫–∞|–∂—ñ–Ω–∫–∞-–µ–ª–µ–∫—Ç—Ä–æ—Ç–µ—Ö–Ω—ñ–∫|–∂—ñ–Ω–∫–∞-–º–µ—Ö–∞–Ω—ñ–∫|–∂—ñ–Ω–∫–∞-—Å–∞–Ω—Ç–µ—Ö–Ω—ñ–∫|–∂—ñ–Ω–∫–∞-—Ñ–∞—Ö—ñ–≤–µ—Ü—å|–º–∞–π—Å—Ç—Ä–∏–Ω—è|–ø–æ–ª–∞–≥–æ–¥–∏—Ç–∏|—Ä–æ–±–æ—Ç–∞
üë©‚Äçüî¨	–∂—ñ–Ω–∫–∞-–Ω–∞—É–∫–æ–≤–µ—Ü—å	–∂—ñ–Ω–∫–∞|–∂—ñ–Ω–∫–∞-–±—ñ–æ–ª–æ–≥|–∂—ñ–Ω–∫–∞-—ñ–Ω–∂–µ–Ω–µ—Ä|–∂—ñ–Ω–∫–∞-–Ω–∞—É–∫–æ–≤–µ—Ü—å|–∂—ñ–Ω–∫–∞-—Ñ—ñ–∑–∏–∫|–∂—ñ–Ω–∫–∞-—Ö—ñ–º—ñ–∫|–Ω–∞—É–∫–∞|–Ω–∞—É–∫–æ–≤–µ—Ü—å|—Ä–æ–±–æ—Ç–∞
üë©‚ÄçüöÄ	–∞—Å—Ç—Ä–æ–Ω–∞–≤—Ç–∫–∞	–∞—Å—Ç—Ä–æ–Ω–∞–≤—Ç–∫–∞|–∂—ñ–Ω–∫–∞|–∂—ñ–Ω–∫–∞-–∫–æ—Å–º–æ–Ω–∞–≤—Ç|–∫–æ—Å–º–æ–Ω–∞–≤—Ç–∫–∞|—Ä–∞–∫–µ—Ç–∞|—Ä–æ–±–æ—Ç–∞
üë©‚Äçüöí	–∂—ñ–Ω–∫–∞-–ø–æ–∂–µ–∂–Ω–∏–∫	–∂—ñ–Ω–∫–∞|–∂—ñ–Ω–∫–∞-–≤–æ–≥–Ω–µ–±–æ—Ä–µ—Ü—å|–∂—ñ–Ω–∫–∞-–ø–æ–∂–µ–∂–Ω–∏–∫|–ø–æ–∂–µ–∂–Ω–∏–π –∞–≤—Ç–æ–º–æ–±—ñ–ª—å|–ø–æ–∂–µ–∂–Ω–∏–∫|—Ä–æ–±–æ—Ç–∞
üë©‚Äçü¶Ø	–∂—ñ–Ω–∫–∞ –∑ —Ç–∞–∫—Ç–∏–ª—å–Ω–æ—é —Ç—Ä–æ—Å—Ç–∏–Ω–æ—é	–±—ñ–ª–∞|–±—ñ–ª–∏–π|–¥–æ—Å—Ç—É–ø–Ω—ñ—Å—Ç—å|–∂—ñ–Ω–∫–∞|–Ω–µ–∑—Ä—è—á–∞|—Å–ª—ñ–ø–∞|—Å–ø–µ—Ü—ñ–∞–ª—å–Ω—ñ –º–æ–∂–ª–∏–≤–æ—Å—Ç—ñ|—Ç—Ä–æ—Å—Ç–∏–Ω–∞|—Ü—ñ–ø–æ–∫
üë©‚Äçü¶º	–∂—ñ–Ω–∫–∞ —É –≤—ñ–∑–∫—É –∑ –µ–ª–µ–∫—Ç—Ä–æ–ø—Ä–∏–≤–æ–¥–æ–º	–≤—ñ–∑–æ–∫|–¥–æ—Å—Ç—É–ø–Ω—ñ—Å—Ç—å|–∂—ñ–Ω–∫–∞|–∂—ñ–Ω–∫–∞ —É –≤—ñ–∑–∫—É –∑ –µ–ª–µ–∫—Ç—Ä–æ–ø—Ä–∏–≤–æ–¥–æ–º|–∫–æ–ª—ñ—Å–Ω–µ –∫—Ä—ñ—Å–ª–æ|–ª—é–¥–∏–Ω–∞|—Å–ø–µ—Ü—ñ–∞–ª—å–Ω—ñ –º–æ–∂–ª–∏–≤–æ—Å—Ç—ñ
üë©‚Äçü¶Ω	–∂—ñ–Ω–∫–∞ —É –≤—ñ–∑–∫—É –∑ —Ä—É—á–Ω–∏–º –ø—Ä–∏–≤–æ–¥–æ–º	–≤—ñ–∑–æ–∫|–¥–æ—Å—Ç—É–ø–Ω—ñ—Å—Ç—å|–∂—ñ–Ω–∫–∞|–∂—ñ–Ω–∫–∞ —É –≤—ñ–∑–∫—É –∑ —Ä—É—á–Ω–∏–º –ø—Ä–∏–≤–æ–¥–æ–º|–∫–æ–ª—ñ—Å–Ω–µ –∫—Ä—ñ—Å–ª–æ|–ª—é–¥–∏–Ω–∞|—Å–ø–µ—Ü—ñ–∞–ª—å–Ω—ñ –º–æ–∂–ª–∏–≤–æ—Å—Ç—ñ
üë™	—Ä–æ–¥–∏–Ω–∞	–±–∞—Ç—å–∫–æ|–¥–∏—Ç–∏–Ω–∞|–º–∞–º–∞|–º–∞—Ç—ñ—Ä|—Ä–æ–¥–∏–Ω–∞|—Å—ñ–º º—è|—Ç–∞—Ç–æ
üë´	–∂—ñ–Ω–∫–∞ –π —á–æ–ª–æ–≤—ñ–∫, —â–æ —Ç—Ä–∏–º–∞—é—Ç—å—Å—è –∑–∞ —Ä—É–∫–∏	–±–ª–∏–∑–Ω—è—Ç–∞|–¥—Ä—É–∂–±–∞|–∂—ñ–Ω–∫–∞|–∑–∞ —Ä—É–∫–∏|–ø–∞—Ä–∞|–ø–æ–±–∞—á–µ–Ω–Ω—è|—Ç—Ä–∏–º–∞—Ç–∏|—Ñ–ª—ñ—Ä—Ç|—á–æ–ª–æ–≤—ñ–∫
üë¨	—á–æ–ª–æ–≤—ñ–∫–∏, —â–æ —Ç—Ä–∏–º–∞—é—Ç—å—Å—è –∑–∞ —Ä—É–∫–∏	–±–ª–∏–∑–Ω—é–∫–∏|–ë–ª–∏–∑–Ω—è—Ç–∞|–¥—Ä—É–∂–±–∞|–∑–∞ —Ä—É–∫–∏|–∑–æ–¥—ñ–∞–∫|–ª–≥–±—Ç|–ø–∞—Ä–∞|—Ñ–ª—ñ—Ä—Ç|—Ö–ª–æ–ø—Ü—ñ|—á–æ–ª–æ–≤—ñ–∫–∏
üë≠	–∂—ñ–Ω–∫–∏, —â–æ —Ç—Ä–∏–º–∞—é—Ç—å—Å—è –∑–∞ —Ä—É–∫–∏	–¥—ñ–≤—á–∞—Ç–∞|–∂—ñ–Ω–∫–∏|–∂—ñ–Ω–∫–∏, —â–æ —Ç—Ä–∏–º–∞—é—Ç—å—Å—è –∑–∞ —Ä—É–∫–∏|–ø–∞—Ä–∞|–ø–æ–¥—Ä—É–≥–∏|–ø–æ–¥—Ä—É–∂–∫–∏|—Ä—É–∫–∞|—Ç—Ä–∏–º–∞—é—Ç—å—Å—è –∑–∞ —Ä—É–∫–∏|—â–æ —Ç—Ä–∏–º–∞—é—Ç—å—Å—è –∑–∞ —Ä—É–∫–∏
üëÆ	–ø—Ä–∞—Ü—ñ–≤–Ω–∏–∫ –ø–æ–ª—ñ—Ü—ñ—ó	–∫–æ–ø|–æ—Ñ—ñ—Ü–µ—Ä|–ø–æ–ª—ñ—Ü–µ–π—Å—å–∫–∏–π|–ø–æ–ª—ñ—Ü–µ–π—Å—å–∫–∏–π –ø—ñ–¥ –ø—Ä–∏–∫—Ä–∏—Ç—Ç—è–º|–ø–æ–ª—ñ—Ü—ñ—è|–ø—Ä–∞—Ü—ñ–≤–Ω–∏–∫ –ø–æ–ª—ñ—Ü—ñ—ó|—Å–ø—ñ–≤—Ä–æ–±—ñ—Ç–Ω–∏–∫|—à—Ç—Ä–∞—Ñ—É–≤–∞—Ç–∏
üëØ	–ª—é–¥–∏ –∑ –∫—Ä–æ–ª—è—á–∏–º–∏ –≤—É—Ö–∞–º–∏	–±–ª–∏–∑–Ω—é–∫–∏|–≤–µ—á—ñ—Ä–∫–∞|–≤—É—Ö–∞|–¥—ñ–≤—á–∏–Ω–∞|–∂—ñ–Ω–∫–∞|–∫—Ä–æ–ª–∏–∫|–ª—é–¥–∏|–ª—é–¥–∏ –∑ –∫—Ä–æ–ª—è—á–∏–º–∏ –≤—É—Ö–∞–º–∏|–Ω–∞–π–∫—Ä–∞—â—ñ –¥—Ä—É–∑—ñ|–æ–¥–Ω–∞–∫–æ–≤—ñ|–ø–∞—Ä–∞|—Ç–∞–Ω—Ü—ñ–≤–Ω–∏—Ü—ñ|—Ç–∞–Ω—Ü—ñ–≤–Ω–∏—Ü—è
üë∞	–ª—é–¥–∏–Ω–∞ —É —Ñ–∞—Ç—ñ	–≤–µ—Å—ñ–ª–ª—è|–ª—é–¥–∏–Ω–∞|–ª—é–¥–∏–Ω–∞ –∑ —Ñ–∞—Ç–æ—é|–ª—é–¥–∏–Ω–∞ —É —Ñ–∞—Ç—ñ|–Ω–∞—Ä–µ—á–µ–Ω–∞|—Ñ–∞—Ç–∞
üë±	–ª—é–¥–∏–Ω–∞ –∑ –±—ñ–ª—è–≤–∏–º –≤–æ–ª–æ—Å—Å—è–º	–±—ñ–ª—è–≤–µ|–±–ª–æ–Ω–¥|–±–ª–æ–Ω–¥–∏–Ω|–≤–æ–ª–æ—Å—Å—è|–ª—é–¥–∏–Ω–∞|–ª—é–¥–∏–Ω–∞ –∑ –±—ñ–ª—è–≤–∏–º –≤–æ–ª–æ—Å—Å—è–º|–ª—é–¥–∏–Ω–∞ –∑—ñ —Å–≤—ñ—Ç–ª–∏–º –≤–æ–ª–æ—Å—Å—è–º|–æ–±–ª–∏—á—á—è|—Å–≤—ñ—Ç–ª–µ –≤–æ–ª–æ—Å—Å—è|—Å–≤—ñ—Ç–ª–∏–π
üë≤	—á–æ–ª–æ–≤—ñ–∫ —É –∫–∏—Ç–∞–π—Å—å–∫—ñ–π —à–∞–ø—Ü—ñ	–≥—É–∞ –ø—ñ –º–∞–æ|–∫—Ä—É–≥–ª–∞|—á–æ–ª–æ–≤—ñ–∫|—á–æ–ª–æ–≤—ñ–∫ –≤ –∫–µ–ø—Ü—ñ|—á–æ–ª–æ–≤—ñ–∫ —É –∫–∏—Ç–∞–π—Å—å–∫—ñ–π —à–∞–ø—Ü—ñ|—à–∞–ø–æ—á–∫–∞
üë≥	–ª—é–¥–∏–Ω–∞ –≤ —Ç—é—Ä–±–∞–Ω—ñ	–ª—é–¥–∏–Ω–∞|–ª—é–¥–∏–Ω–∞ –≤ —Ç—é—Ä–±–∞–Ω—ñ|—Ç—é—Ä–±–∞–Ω
üë¥	–ª—ñ—Ç–Ω—ñ–π —á–æ–ª–æ–≤—ñ–∫	–¥–æ—Ä–æ—Å–ª–∏–π|–ª–∏—Å–∏–π|–ª—ñ—Ç–Ω—ñ–π —á–æ–ª–æ–≤—ñ–∫|–ø—Ä–∏—Å—Ç–∞—Ä—ñ–ª–∏–π|—Å—Ç–∞—Ä–∏–π|—á–æ–ª–æ–≤—ñ–∫
üëµ	–ª—ñ—Ç–Ω—è –∂—ñ–Ω–∫–∞	–±–∞–±—É—Å—è|–≤ –ª—ñ—Ç–∞—Ö|–¥–æ—Ä–æ—Å–ª–∞|–∂—ñ–Ω–∫–∞|–ª—ñ—Ç–Ω—è –∂—ñ–Ω–∫–∞|–ª—é–¥–∏–Ω–∞|—Å—Ç–∞—Ä–∞
üë∂	–Ω–µ–º–æ–≤–ª—è	–¥–∏—Ç–∏–Ω–∞|–º–∞–ª–µ—á–∞|–Ω–µ–º–æ–≤–ª—è
üë∑	–±—É–¥—ñ–≤–µ–ª—å–Ω–∏–∫	–±—É–¥—ñ–≤–µ–ª—å–Ω–∏–∫|–±—É–¥—ñ–≤–Ω–∏—Ü—Ç–≤–æ|–±—É–¥—É–≤–∞—Ç–∏|–∫–∞—Å–∫–∞|–ø—Ä–∞—Ü—ñ–≤–Ω–∏–∫|—Ä–µ–º–æ–Ω—Ç|—Ä–µ–º–æ–Ω—Ç—É–≤–∞—Ç–∏|—Ä–æ–±—ñ—Ç–Ω–∏–∫|—Ä–æ–±–æ—Ç–∞|—à–æ–ª–æ–º
üë∏	–ø—Ä–∏–Ω—Ü–µ—Å–∞	–∫–∞–∑–∫–æ–≤–∞|–∫–æ—Ä–æ–ª–µ–≤–∞|–∫–æ—Ä–æ–ª—ñ–≤–Ω–∞|–∫–æ—Ä–æ–Ω–∞|–ø—Ä–∏–Ω—Ü–µ—Å–∞|—Ä–æ–±–æ—Ç–∞|—á–∞—Ä—ñ–≤–Ω–∞
üëπ	–≤–µ–ª–µ—Ç–µ–Ω—å-–ª—é–¥–æ–∂–µ—Ä	–≤–µ–ª–µ—Ç–µ–Ω—å-–ª—é–¥–æ–∂–µ—Ä|–∫–∞–∑–∫–∞|–ª—é–¥–æ–∂–µ—Ä|–º–æ–Ω—Å—Ç—Ä|–æ–±–ª–∏—á—á—è|—Å—Ç–≤–æ—Ä—ñ–Ω–Ω—è|—Ñ–∞–Ω—Ç–∞–∑—ñ—è|—è–ø–æ–Ω—Å—å–∫–∏–π
üë∫	–≥–æ–±–ª—ñ–Ω	–≥–æ–±–ª—ñ–Ω|–∫–∞–∑–∫–∞|–º–æ–Ω—Å—Ç—Ä|–æ–±–ª–∏—á—á—è|—Å—Ç–≤–æ—Ä—ñ–Ω–Ω—è|—Ñ–∞–Ω—Ç–∞–∑—ñ—è|—è–ø–æ–Ω—Å—å–∫–∏–π
üëª	–ø—Ä–∏–≤–∏–¥	–∫–∞–∑–∫–∞|–∫–∞—Å–ø–µ—Ä|–º–æ–Ω—Å—Ç—Ä|–æ–±–ª–∏—á—á—è|–ø—Ä–∏–≤–∏–¥|—Å—Ç–≤–æ—Ä—ñ–Ω–Ω—è|—Ñ–∞–Ω—Ç–∞–∑—ñ—è
üëº	—è–Ω–≥–æ–ª—è—Ç–∫–æ	–∞–Ω–≥–µ–ª|–∫–∞–∑–∫–∞|–Ω–µ–º–æ–≤–ª—è|–æ–±–ª–∏—á—á—è|—Ñ–∞–Ω—Ç–∞–∑—ñ—è
üëΩ	–ø—Ä–∏–±—É–ª–µ—Ü—å	–∫–∞–∑–∫–∞|–Ω–ª–æ|–æ–±–ª–∏—á—á—è|–ø–æ–∑–∞–∑–µ–º–Ω–∏–π|–ø—Ä–∏–±—É–ª–µ—Ü—å|—Å—Ç–≤–æ—Ä—ñ–Ω–Ω—è|—á—É–∂–∏–π
üëæ	—ñ–Ω—à–æ–ø–ª–∞–Ω–µ—Ç–Ω–∏–π –º–æ–Ω—Å—Ç—Ä	—ñ–Ω—à–æ–ø–ª–∞–Ω–µ—Ç–Ω–∏–π –º–æ–Ω—Å—Ç—Ä|–∫–æ—Å–º–æ—Å|–º–æ–Ω—Å—Ç—Ä|–Ω–ª–æ|–æ–±–ª–∏—á—á—è|–ø–æ–∑–∞–∑–µ–º–Ω–∏–π|–ø—Ä–∏–±—É–ª–µ—Ü—å|–ø—Ä–∏–±—É–ª–µ—Ü—å-–º–æ–Ω—Å—Ç—Ä|—Å—Ç–≤–æ—Ä—ñ–Ω–Ω—è|—Ñ–∞–Ω—Ç–∞–∑—ñ—è
üëø	—Å–µ—Ä–¥–∏—Ç–µ –æ–±–ª–∏—á—á—è –∑ —Ä–æ–≥–∞–º–∏	–¥–µ–º–æ–Ω|–¥–∏—è–≤–æ–ª|–¥—ñ–¥—å–∫–æ|–∑ —Ä–æ–≥–∞–º–∏|–æ–±–ª–∏—á—á—è|—Ñ–∞–Ω—Ç–∞–∑—ñ—è|—á–æ—Ä—Ç–µ–Ω—è
üíÄ	—á–µ—Ä–µ–ø	–∫–∞–∑–∫–∞|–º–æ–Ω—Å—Ç—Ä|–æ–±–ª–∏—á—á—è|—Å–º–µ—Ä—Ç—å|—Ç—ñ–ª–æ|—á–µ—Ä–µ–ø
üíÅ	–ª—é–¥–∏–Ω–∞, —â–æ –ø—Ä–æ—Å—Ç—è–≥–∞—î —Ä—É–∫—É –¥–æ–ø–æ–º–æ–≥–∏	–±–∞–π–¥—É–∂–µ|–¥–æ–≤—ñ–¥–∫–∞|–¥–æ–ø–æ–º–æ–≥–∞|—ñ–Ω—Ñ–æ—Ä–º–∞—Ü—ñ—è|—Å–∞—Ä–∫–∞–∑–º|—Å–µ—Ä–π–æ–∑–Ω–æ|—á–∞–π–æ–≤—ñ
üíÇ	–≤–∞—Ä—Ç–∞	–≤–∞—Ä—Ç–∞|–∫–∞—Ä–∞—É–ª|–æ—Ö–æ—Ä–æ–Ω–∞|—Å—Ç–æ—Ä–æ–∂–∞|—á–∞—Ç–∏
üíÉ	–∂—ñ–Ω–∫–∞, —â–æ —Ç–∞–Ω—Ü—é—î	–∂—ñ–Ω–∫–∞|—Å–∞–ª—å—Å–∞|—Å—É–∫–Ω—è|—Ç–∞–Ω–≥–æ|—Ç–∞–Ω–µ—Ü—å|—Ç–∞–Ω–æ–∫|—Ñ–ª–∞–º–µ–Ω–∫–æ
üíÑ	–ø–æ–º–∞–¥–∞	–≥—É–±–Ω–∞ –ø–æ–º–∞–¥–∞|–∫–æ—Å–º–µ—Ç–∏–∫–∞|–ø–æ–º–∞–¥–∞|—á–µ—Ä–≤–æ–Ω–∞ –ø–æ–º–∞–¥–∞
üíÖ	–ª–∞–∫ –¥–ª—è –Ω—ñ–≥—Ç—ñ–≤	–¥–æ–≥–ª—è–¥|–∫–æ—Å–º–µ—Ç–∏–∫–∞|–ª–∞–∫|–ª–∞–∫ –¥–ª—è –Ω—ñ–≥—Ç—ñ–≤|–º–∞–Ω—ñ–∫—é—Ä|–Ω—ñ–≥–æ—Ç—å|–Ω—ñ–≥—Ç—ñ|—Ä–æ–±–æ—Ç–∞|—Ä—É–∫–∞|—Ç—ñ–ª–æ
üíÜ	–ª—é–¥–∏–Ω–∞, —è–∫—ñ–π —Ä–æ–±–ª—è—Ç—å –º–∞—Å–∞–∂ –≥–æ–ª–æ–≤–∏	–≤—ñ–¥–ø–æ—á–∏–Ω–æ–∫|–≥–æ–ª–æ–≤–∞|–¥–æ–≥–ª—è–¥|–º–∞—Å–∞–∂|–æ–±–ª–∏—á—á—è|—Ä–µ–ª–∞–∫—Å|—Å–∞–ª–æ–Ω|—Ç—É—Ä–±–æ—Ç–∞
üíá	–ª—é–¥–∏–Ω–∞, —è–∫—ñ–π —Ä–æ–±–ª—è—Ç—å —Å—Ç—Ä–∏–∂–∫—É	–≤–æ–ª–æ—Å—Å—è|–∑–∞—á—ñ—Å–∫–∞|–∫–æ—Å–º–µ—Ç–æ–ª–æ–≥—ñ—è|–∫—Ä–∞—Å–∞|–ø–µ—Ä—É–∫–∞—Ä|–ø–µ—Ä—É–∫–∞—Ä–Ω—è|—Å–∞–ª–æ–Ω|—Å—Ç—Ä–∏–∂–∫–∞
üíà	–≤–∏–≤—ñ—Å–∫–∞ –ø–µ—Ä—É–∫–∞—Ä—è (—Å–º—É–≥–∞—Å—Ç–∏–π —Å—Ç–æ–≤–ø)	–≤–∏–≤—ñ—Å–∫–∞|–≤–∏–≤—ñ—Å–∫–∞ –ø–µ—Ä—É–∫–∞—Ä—è|–≤–∏–≤—ñ—Å–∫–∞ –ø–µ—Ä—É–∫–∞—Ä—è (—Å–º—É–≥–∞—Å—Ç–∏–π —Å—Ç–æ–≤–ø)|–∑–∞—á—ñ—Å–∫–∞|–ø–µ—Ä—É–∫–∞—Ä|–ø–µ—Ä—É–∫–∞—Ä–Ω—è
üíâ	—à–ø—Ä–∏—Ü	–≥–æ–ª–∫–∞|—ñ–Ω—Å—Ç—Ä—É–º–µ–Ω—Ç|–ª—ñ–∫–∞—Ä|–ª—ñ–∫–∏|—É–∫–æ–ª|—Ö–≤–æ—Ä–∏–π|—à–ø—Ä–∏—Ü
üíä	–ø—ñ–≥—É–ª–∫–∞	–∑–∞ —Ä–µ—Ü–µ–ø—Ç–æ–º|–ª—ñ–∫–∞—Ä|–ª—ñ–∫–∏|–ø—ñ–≥—É–ª–∫–∞|—Ö–≤–æ—Ä–∏–π
üíã	—Å–ª—ñ–¥ —Ü—ñ–ª—É–Ω–∫—É	–≤—ñ–¥–±–∏—Ç–æ–∫|–≤—É—Å—Ç–∞|–≥—É–±–∏|–∑–∞–∫–æ—Ö–∞–Ω—ñ—Å—Ç—å|–ø–æ—Ü—ñ–ª—É–Ω–æ–∫|—Å–µ—Ä—Ü–µ
üíå	–ª—é–±–æ–≤–Ω–∏–π –ª–∏—Å—Ç	–∑–∞–∫–æ—Ö–∞–Ω—ñ—Å—Ç—å|–∑–∞–∫–æ—Ö–∞–Ω—Å—ñ—Ç—å|–∫–æ—Ö–∞–Ω–Ω—è|–ª–∏—Å—Ç|–ª—é–±–æ–≤–Ω–∏–π –ª–∏—Å—Ç|–ø–æ—à—Ç–∞|—Å–µ—Ä—Ü–µ
üíç	–∫–∞–±–ª—É—á–∫–∞	–≤–∏—Ö–æ–¥—å –∑–∞ –º–µ–Ω–µ|–¥—ñ–∞–º–∞–Ω—Ç|–∑–∞—Ä—É—á–µ–Ω–Ω—è|–∫–∞–±–ª—É—á–∫–∞|–∫–æ—Ö–∞–Ω–Ω—è|–ø—Ä–æ–ø–æ–∑–∏—Ü—ñ—è
üíé	–∫–æ—à—Ç–æ–≤–Ω–∏–π –∫–∞–º—ñ–Ω—å	–¥—ñ–∞–º–∞–Ω—Ç|–¥–æ—Ä–æ–≥–æ—Ü—ñ–Ω–Ω–∏–π|–∫–∞–º—ñ–Ω—å|–∫–æ—Ö–∞–Ω–Ω—è|–∫–æ—à—Ç–æ–≤–Ω–∏–π –∫–∞–º—ñ–Ω—å
üíè	—á–æ–ª–æ–≤—ñ–∫ —ñ –∂—ñ–Ω–∫–∞, —â–æ —Ü—ñ–ª—É—é—Ç—å—Å—è	–∑–∞–∫–æ—Ö–∞–Ω—ñ—Å—Ç—å|–∫–æ—Ö–∞–Ω–Ω—è|–ª—é–±–æ–≤|–ª—é–¥–∏–Ω–∞|–ø–∞—Ä–∞|–ø–æ–±–∞—á–µ–Ω–Ω—è|–ø–æ—Ü—ñ–ª—É–Ω–æ–∫|—Ä—ñ—á–Ω–∏—Ü—è|—Å—Ç–æ—Å—É–Ω–∫–∏
üíê	–±—É–∫–µ—Ç	–±—É–∫–µ—Ç|–∫–≤—ñ—Ç–∏|–∫–≤—ñ—Ç–∫–∞|–∫–æ—Ö–∞–Ω–Ω—è|—Ä–æ–∑–∏|—Ä–æ—Å–ª–∏–Ω–∞
üíë	—á–æ–ª–æ–≤—ñ–∫ —ñ –∂—ñ–Ω–∫–∞ —ñ–∑ —Å–µ—Ä—Ü–µ–º –º—ñ–∂ –Ω–∏–º–∏	–∑–∞–∫–æ—Ö–∞–Ω—ñ—Å—Ç—å|–∫–æ—Ö–∞–Ω–Ω—è|–∫–æ—Ö–∞—é —Ç–µ–±–µ|–ø–∞—Ä–∞|–ø–æ–±–∞—á–µ–Ω–Ω—è|—Å–µ—Ä—Ü–µ|—Å—Ç–æ—Å—É–Ω–∫–∏|—á–æ–ª–æ–≤—ñ–∫ —ñ –∂—ñ–Ω–∫–∞ —ñ–∑ —Å–µ—Ä—Ü–µ–º –º—ñ–∂ –Ω–∏–º–∏
üíí	–≤–µ—Å—ñ–ª–ª—è	–≤–µ—Å—ñ–ª–ª—è|–∫–∞–ø–ª–∏—Ü—è|–∫–æ—Ö–∞–Ω–Ω—è|—Ü–µ—Ä–µ–º–æ–Ω—ñ—è
üíì	—Å–µ—Ä—Ü–µ, —â–æ –± º—î—Ç—å—Å—è	–±–∏—Ç—Ç—è|–µ–º–æ—Ü—ñ—è|–∫–∞—Ä–¥—ñ–æ|–∫–æ—Ö–∞–Ω–Ω—è|–∫–æ—Ö–∞—é|–ª—é–±–ª—é|–ø—É–ª—å—Å—É–≤–∞—Ç–∏|–ø—É–ª—å—Å—É—é—á–µ|—Å–µ—Ä—Ü–µ|—Å–µ—Ä—Ü–µ–±–∏—Ç—Ç—è|—è—Ç–∫|—è—Ç–ª
üíî	—Ä–æ–∑–±–∏—Ç–µ —Å–µ—Ä—Ü–µ	–µ–º–æ—Ü—ñ—è|—Ä–æ–∑–±–∏–≤–∞—Ç–∏|—Ä–æ–∑–±–∏—Ç–µ|—Ä–æ–∑–ª—É–∫–∞|—Å–∞–º–æ—Ç–Ω—ñ–π|—Å—É–º
üíï	–¥–≤–∞ —Å–µ—Ä—Ü—è	–∫–æ—Ö–∞–Ω–Ω—è|–∫–æ—Ö–∞—é|–ª—é–±–ª—é|–ª—é–±–æ–≤|–ø–∞—Ä–∞|–ø–æ—Ü—ñ–ª—É–Ω–æ–∫|—Å–µ—Ä—Ü—è|—è—Ç–∫|—è—Ç–ª
üíñ	—Å–µ—Ä—Ü–µ, —â–æ –≤–∏–±–ª–∏—Å–∫—É—î	–±–ª–∏—Å–∫—ñ—Ç–∫–∏|–±–ª–∏—Å–∫—É—á–µ|–∑–∞—Ö–æ–ø–ª–µ–Ω–Ω—è|–∫–æ—Ö–∞—é|–ª—é–±–ª—é|—Ä–æ–∂–µ–≤–µ|—Å–µ—Ä—Ü–µ|—Å—è–π–≤–æ|—â–∞—Å—Ç—è|—è—Ç–∫|—è—Ç–ª
üíó	—Å–µ—Ä—Ü–µ, —â–æ –∑—Ä–æ—Å—Ç–∞—î	–µ–º–æ—Ü—ñ—è|–∑–∞—Ö–æ–ø–ª–µ–Ω–Ω—è|–∑–±—ñ–ª—å—à—É—î—Ç—å—Å—è|–∑—Ä–æ—Å—Ç–∞—î|–Ω–µ—Ä–≤—É–≤–∞—Ç–∏|—Å–µ—Ä—Ü–µ|—Å–µ—Ä—Ü–µ–±–∏—Ç—Ç—è|—è —Ç–µ–±–µ –∫–æ—Ö–∞—é|—è —Ç–µ–±–µ –ª—é–±–ª—é|—è—Ç–∫|—è—Ç–ª
üíò	—Å–µ—Ä—Ü–µ, –ø—Ä–æ–±–∏—Ç–µ —Å—Ç—Ä—ñ–ª–æ—é	–∑–∞–∫–æ—Ö–∞–Ω—ñ—Å—Ç—å|–∫—É–ø—ñ–¥–æ–Ω|–ø—Ä–æ–±–∏—Ç–µ —Å—Ç—Ä—ñ–ª–æ—é|—Å–µ—Ä—Ü–µ|—Å–µ—Ä—Ü–µ –∑—ñ —Å—Ç—Ä—ñ–ª–æ—é|—Å–µ—Ä—Ü–µ, –ø—Ä–æ–±–∏—Ç–µ —Å—Ç—Ä—ñ–ª–æ—é|—Å—Ç—Ä—ñ–ª–∞
üíô	—Å–∏–Ω—î —Å–µ—Ä—Ü–µ	—Å–µ—Ä—Ü–µ|—Å–∏–Ω—î —Å–µ—Ä—Ü–µ|—Å–∏–Ω—ñ–π|—Ö–æ–ª–æ–¥–Ω–µ —Å–µ—Ä—Ü–µ
üíö	–∑–µ–ª–µ–Ω–µ —Å–µ—Ä—Ü–µ	–∑–µ–ª–µ–Ω–µ —Å–µ—Ä—Ü–µ|–∑–µ–ª–µ–Ω–∏–π|–∫–æ—Ö–∞–Ω–Ω—è|—Å–µ—Ä—Ü–µ
üíõ	–∂–æ–≤—Ç–µ —Å–µ—Ä—Ü–µ	–∂–æ–≤—Ç–µ —Å–µ—Ä—Ü–µ|–∂–æ–≤—Ç–∏–π|–∫–æ—Ö–∞–Ω–Ω—è|—Å–µ—Ä—Ü–µ
üíú	–ø—É—Ä–ø—É—Ä–æ–≤–µ —Å–µ—Ä—Ü–µ	–±—É–∑–∫–æ–≤–∏–π|–ø—É—Ä–ø—É—Ä–Ω–∏–π|–ø—É—Ä–ø—É—Ä–æ–≤–µ —Å–µ—Ä—Ü–µ|–ø—É—Ä–ø—É—Ä–æ–≤–∏–π|—Å–µ—Ä—Ü–µ|—Ñ—ñ–æ–ª–µ—Ç–æ–≤–µ —Å–µ—Ä—Ü–µ|—Ñ—ñ–æ–ª–µ—Ç–æ–≤–∏–π|—à–∞—Ä–ª–∞—Ç–æ–≤–∏–π
üíù	—Å–µ—Ä—Ü–µ –∑—ñ —Å—Ç—Ä—ñ—á–∫–æ—é	–≤–∞–ª–µ–Ω—Ç–∏–Ω|–∫–æ—Ö–∞–Ω–Ω—è|—Å–µ—Ä—Ü–µ|—Å–µ—Ä—Ü–µ –∑—ñ —Å—Ç—Ä—ñ—á–∫–æ—é|—Å—Ç—Ä—ñ—á–∫–∞
üíû	—Å–µ—Ä—Ü—è, —â–æ –æ–±–µ—Ä—Ç–∞—é—Ç—å—Å—è	–µ–º–æ—Ü—ñ—è|–∫–æ—Ö–∞–Ω–Ω—è|–ª—é–±–æ–≤|–æ–±–µ—Ä—Ç–∞—Ç–∏—Å—è|—Ä—ñ—á–Ω–∏—Ü—è|—Å–µ—Ä—Ü–µ
üíü	–ø—Ä–∏–∫—Ä–∞—Å–∞ —ñ–∑ —Å–µ—Ä—Ü–µ–º	143|–±—ñ–ª–∏–π|–∫–æ—Ö–∞–Ω–Ω—è|–ø—Ä–∏–∫—Ä–∞—Å–∞ —ñ–∑ —Å–µ—Ä—Ü–µ–º|—Å–µ—Ä—Ü–µ|—Å—Ç–∏–ª—ñ–∑–æ–≤–∞–Ω–µ|—Ñ—ñ–æ–ª–µ—Ç–æ–≤–∏–π
üí†	—Ä–æ–º–± —ñ–∑ –∫—Ä–∞–ø–∫–æ—é	–≥–µ–æ–º–µ—Ç—Ä–∏—á–Ω–∏–π|–¥—ñ–∞–º–∞–Ω—Ç|–∫—Ä–∞–ø–∫–∞|–º–∞–ª—é–Ω–æ–∫|—Ä–æ–º–± —ñ–∑ –∫—Ä–∞–ø–∫–æ—é
üí°	–ª–∞–º–ø–æ—á–∫–∞	–µ–ª–µ–∫—Ç—Ä–∏—á–Ω–∏–π|—ñ–¥–µ—è|–ª–∞–º–ø–æ—á–∫–∞|–º–∞–ª—é–Ω–æ–∫|—Å–≤—ñ—Ç–ª–æ
üí¢	—Å–∏–º–≤–æ–ª –≥–Ω—ñ–≤—É	–≥–Ω—ñ–≤|–∑–ª–∏–π|–∫–æ–º—ñ–∫—Å–∏|—Ä–æ–∑–ª—é—á–µ–Ω–∏–π
üí£	–±–æ–º–±–∞	–±–æ–º–±–∞|–≤–∏–±—É—Ö|–∫–æ–º—ñ–∫—Å–∏|–Ω–µ–±–µ–∑–ø–µ—á–Ω–∏–π
üí§	—É–º–æ–≤–Ω–µ –ø–æ–∑–Ω–∞—á–µ–Ω–Ω—è —Å–Ω—É	–¥–æ–±—Ä–∞–Ω—ñ—á|–∫–æ–º—ñ–∫—Å–∏|–Ω—ñ—á|—Å–æ–Ω|—Å–ø–∞—Ç–∏|—Å–ø–∏—Ç—å|—Å–ø–ª—é|—Å—Ç–æ–º–ª–µ–Ω–∏–π|—Ö—Ä—Ä
üí•	–∑—ñ—Ç–∫–Ω–µ–Ω–Ω—è	–±–∞—Ö|–±—É–º|–≤–∏–±—É—Ö|—ñ—Å–∫—Ä–∞|–∫–æ–º—ñ–∫—Å–∏|—Å–ø–∞–ª–∞—Ö
üí¶	–∫—Ä–∞–ø–ª—ñ –ø–æ—Ç—É	–±—Ä–∏–∑–∫–∏|–≤–æ–¥–∞|–∫–æ–º—ñ–∫—Å–∏|–∫—Ä–∞–ø–ª—ñ|–∫—Ä–∞–ø–ª—ñ –ø–æ—Ç—É|–ø—ñ—Ç
üíß	–∫—Ä–∞–ø–ª—è	–∫–æ–º—ñ—á–Ω–∏–π|–∫—Ä–∞–ø–ª—è|–ø—ñ—Ç|–ø–æ–≥–æ–¥–∞|—Ö–æ–ª–æ–¥–Ω–∏–π
üí®	–ø–æ—Ä–∏–≤ –≤—ñ—Ç—Ä—É	–±—ñ–≥|–∫–æ–º—ñ–∫—Å–∏|–º—á–∞—Ç–∏|–ø–æ—Ä–∏–≤ –≤—ñ—Ç—Ä—É|—Å—Ç—Ä—ñ–º–∫—ñ—Å—Ç—å|—à–≤–∏–¥–∫–æ
üí©	—É—Å–º—ñ—Ö–Ω–µ–Ω–∞ –∫—É–ø–∞ –ª–∞–π–Ω–∞	–µ–∫—Å–∫—Ä–µ–º–µ–Ω—Ç–∏|–∂–∞—Ä—Ç|–∫–∞–∫–∞|–ª–∞–π–Ω–æ|–ø—É–ø—É|—É—Å–º—ñ—Ö–Ω–µ–Ω–∞ –∫—É–ø–∞ –ª–∞–π–Ω–∞
üí™	–Ω–∞–ø—Ä—É–∂–µ–Ω–∏–π –±—ñ—Ü–µ–ø—Å	–±–æ–¥–∏–±—ñ–ª–¥–µ—Ä|–≤–∞–∂–∫–æ–∞—Ç–ª–µ—Ç|–∑—ñ–≥–Ω—É—Ç–∏–π|–∫—Ä—É—Ç–∏–π|–º‚Äô—è–∑|–º—É—Å–∫—É–ª–∏—Å—Ç–∏–π|—Ä—É–∫–∞|—Å–∏–ª–∞—á|—Å–ø–æ—Ä—Ç|—Ç—Ä–µ–Ω—É–≤–∞–Ω–Ω—è
üí´	—Å–∏–º–≤–æ–ª –∑–∞–ø–∞–º–æ—Ä–æ—á–µ–Ω–Ω—è	–∑–∞–ø–∞–º–æ—Ä–æ—á–µ–Ω–Ω—è|–∑—ñ—Ä–∫–∞|–∫–æ–º—ñ–∫—Å–∏|—Å–∏–º–≤–æ–ª –∑–∞–ø–∞–º–æ—Ä–æ—á–µ–Ω–Ω—è|—Ñ–æ—Ä—Ç—É–Ω–∞|—â–∞—Å–ª–∏–≤–∞ –∑—ñ—Ä–∫–∞
üí¨	—Ç–µ–∫—Å—Ç–æ–≤–∞ –±—É–ª—å–∫–∞	–¥—ñ–∞–ª–æ–≥|–∫–æ–º—ñ–∫—Å–∏|—Ä–æ–∑–º–æ–≤–∞|—Ç–µ–∫—Å—Ç–æ–≤–∞ –±—É–ª—å–∫–∞|—Ö–º–∞—Ä–∏–Ω–∫–∞|—Ö–º–∞—Ä–∏–Ω–∫–∞ –∑ —Ç–µ–∫—Å—Ç–æ–º
üí≠	–±—É–ª—å–∫–∞ —Ä–æ–∑–¥—É–º—ñ–≤	–±—É–ª—å–∫–∞ —Ä–æ–∑–¥—É–º—ñ–≤|–¥—É–º–∫–∞|–∫–æ–º—ñ–∫—Å–∏|—Ö–º–∞—Ä–∏–Ω–∫–∞
üíÆ	–±—ñ–ª–∞ –∫–≤—ñ—Ç–∫–∞	–±—ñ–ª–∞ –∫–≤—ñ—Ç–∫–∞|–∫–≤—ñ—Ç–∫–∞
üíØ	c—Ç–æ –±–∞–ª—ñ–≤	100|–º–∞–∫—Å–∏–º—É–º|–æ—á–∫–∏|–æ—á–æ–∫|—Ä–∞—Ö—É–Ω–æ–∫|—Ä–µ–∑—É–ª—å—Ç–∞—Ç|—Ç–æ—á–Ω–æ|—á–∏—Å–ª–æ
üí∞	–º—ñ—à–æ–∫ –≥—Ä–æ—à–µ–π	–≥—Ä–æ—à—ñ|–¥–æ–ª–∞—Ä|–º—ñ—à–æ–∫|–º—ñ—à–æ–∫ –≥—Ä–æ—à–µ–π|–º—ñ—à–æ–∫ —ñ–∑ –≥—Ä–æ—à–∏–º–∞
üí±	–æ–±–º—ñ–Ω –≤–∞–ª—é—Ç	–±–∞–Ω–∫|–≤–∞–ª—é—Ç–∞|–≥—Ä–æ—à—ñ|–æ–±–º—ñ–Ω|–æ–±–º—ñ–Ω –≤–∞–ª—é—Ç|–æ–±–º—ñ–Ω –≥—Ä–æ—à–µ–π
üí≤	–∑–Ω–∞–∫ –¥–æ–ª–∞—Ä–∞	–≤–∞–ª—é—Ç–∞|–≥—Ä–æ—à—ñ|–¥–æ–ª–∞—Ä|–∑–Ω–∞–∫ –¥–æ–ª–∞—Ä–∞|—Å–∏–º–≤–æ–ª –¥–æ–ª–∞—Ä–∞
üí≥	–∫—Ä–µ–¥–∏—Ç–Ω–∞ –∫–∞—Ä—Ç–∫–∞	–±–∞–Ω–∫|–±–µ–∑–≥–æ—Ç—ñ–≤–∫–æ–≤–∏–π —Ä–æ–∑—Ä–∞—Ö—É–Ω–æ–∫|–≥—Ä–æ—à—ñ|–∫–∞—Ä—Ç–∫–∞|–∫—Ä–µ–¥–∏—Ç–Ω–∞|—Ä–æ–∑—Ä–∞—Ö—É–Ω–æ–∫
üí¥	—î–Ω–æ–≤—ñ –±–∞–Ω–∫–Ω–æ—Ç–∏	–±–∞–Ω–∫|–±–∞–Ω–∫–Ω–æ—Ç–∞|–≤–∞–ª—é—Ç–∞|–≥—Ä–æ—à—ñ|—î–Ω–∞|—î–Ω–æ–≤—ñ –±–∞–Ω–∫–Ω–æ—Ç–∏|–∫—É–ø—é—Ä–∞
üíµ	–¥–æ–ª–∞—Ä–æ–≤—ñ –±–∞–Ω–∫–Ω–æ—Ç–∏	–±–∞–Ω–∫|–±–∞–Ω–∫–Ω–æ—Ç–∞|–≤–∞–ª—é—Ç–∞|–≥—Ä–æ—à—ñ|–¥–æ–ª–∞—Ä|–¥–æ–ª–∞—Ä–æ–≤—ñ –±–∞–Ω–∫–Ω–æ—Ç–∏|–∫—É–ø—é—Ä–∞
üí∂	—î–≤—Ä–æ–≤—ñ –±–∞–Ω–∫–Ω–æ—Ç–∏	–±–∞–Ω–∫|–±–∞–Ω–∫–Ω–æ—Ç–∞|–≤–∞–ª—é—Ç–∞|–≥—Ä–æ—à—ñ|—î–≤—Ä–æ|—î–≤—Ä–æ–≤—ñ –±–∞–Ω–∫–Ω–æ—Ç–∏|–∫—É–ø—é—Ä–∞
üí∑	—Ñ—É–Ω—Ç–æ–≤—ñ –±–∞–Ω–∫–Ω–æ—Ç–∏	–±–∞–Ω–∫|–±–∞–Ω–∫–Ω–æ—Ç–∞|–≤–∞–ª—é—Ç–∞|–≥—Ä–æ—à—ñ|–∫—É–ø—é—Ä–∞|—Ñ—É–Ω—Ç|—Ñ—É–Ω—Ç–æ–≤—ñ –±–∞–Ω–∫–Ω–æ—Ç–∏
üí∏	–≥—Ä–æ—à—ñ –∑ –∫—Ä–∏–ª–∞–º–∏	–±–∞–Ω–∫|–±–∞–Ω–∫–Ω–æ—Ç–∞|–≥—Ä–æ—à—ñ|–≥—Ä–æ—à—ñ –∑ –∫—Ä–∏–ª–∞–º–∏|–¥–æ–ª–∞—Ä|–∫—Ä–∏–ª–∞|–∫—É–ø—é—Ä–∞|–ª—ñ—Ç–∞—Ç–∏
üíπ	–≥—Ä–∞—Ñ—ñ–∫ –∑—Ä–æ—Å—Ç–∞–Ω–Ω—è —ñ –∑–Ω–∞–∫ —î–Ω–∏	–≤–∞–ª—é—Ç–∞|–≤–≥–æ—Ä—É|–≥—Ä–∞—Ñ—ñ–∫ –∑—Ä–æ—Å—Ç–∞–Ω–Ω—è —ñ –∑–Ω–∞–∫ —î–Ω–∏|–≥—Ä–æ—à—ñ|–¥—ñ–∞–≥—Ä–∞–º–∞|—î–Ω–∞|–∑–±—ñ–ª—å—à–µ–Ω–Ω—è|—Ä—ñ—Å—Ç|—Ç–µ–Ω–¥–µ–Ω—Ü—ñ—è
üí∫	—Å–∏–¥—ñ–Ω–Ω—è	–∫—Ä—ñ—Å–ª–æ|–º—ñ—Å—Ü–µ|—Å–∏–¥—ñ–Ω–Ω—è
üíª	–Ω–æ—É—Ç–±—É–∫	–∫–æ–º–ø‚Äô—é—Ç–µ—Ä|–Ω–æ—É—Ç–±—É–∫|–ø–µ—Ä—Å–æ–Ω–∞–ª—å–Ω–∏–π|–ø–∫
üíº	–∫–µ–π—Å	–∫–µ–π—Å|–ø–æ—Ä—Ç—Ñ–µ–ª—å
üíΩ	–∫–æ–º–ø º—é—Ç–µ—Ä–Ω–∏–π –¥–∏—Å–∫	–¥–∏—Å–∫|–∫–æ–º–ø‚Äô—é—Ç–µ—Ä|–º—ñ–Ω—ñ-–¥–∏—Å–∫|–º—ñ–Ω—ñ–¥–∏—Å–∫|–æ–ø—Ç–∏—á–Ω–∏–π
üíæ	–¥–∏—Å–∫–µ—Ç–∞	–¥–∏—Å–∫|–¥–∏—Å–∫–µ—Ç–∞|–∫–æ–º–ø‚Äô—é—Ç–µ—Ä
üíø	–∫–æ–º–ø–∞–∫—Ç-–¥–∏—Å–∫	blu-ray|cd|dvd|–¥–∏—Å–∫|–∫–æ–º–ø‚Äô—é—Ç–µ—Ä|–∫–æ–º–ø–∞–∫—Ç-–¥–∏—Å–∫|–æ–ø—Ç–∏—á–Ω–∏–π
üìÄ	[DVD]-–¥–∏—Å–∫	[DVD]-–¥–∏—Å–∫|blu-ray|cd|DVD-–¥–∏—Å–∫|–¥–∏—Å–∫|–∫–æ–º–ø‚Äô—é—Ç–µ—Ä|–æ–ø—Ç–∏—á–Ω–∏–π
üìÅ	–ø–∞–ø–∫–∞ –¥–ª—è —Ñ–∞–π–ª—ñ–≤	–∑–∞–∫—Ä–∏—Ç–∞|–ø–∞–ø–∫–∞|—Ç–µ–∫–∞|—Ñ–∞–π–ª
üìÇ	–≤—ñ–¥–∫—Ä–∏—Ç–∞ –ø–∞–ø–∫–∞ –¥–ª—è —Ñ–∞–π–ª—ñ–≤	–≤—ñ–¥–∫—Ä–∏—Ç–∞|–ø–∞–ø–∫–∞|—Ç–µ–∫–∞|—Ñ–∞–π–ª
üìÉ	—Å—Ç–æ—Ä—ñ–Ω–∫–∞ —ñ–∑ –∑–∞–≤–∏—Ç–∫–æ–º	–¥–æ–∫—É–º–µ–Ω—Ç|–∑–∞–≤–∏—Ç–æ–∫|—Å—Ç–æ—Ä—ñ–Ω–∫–∞|—Å—Ç–æ—Ä—ñ–Ω–∫–∞ —ñ–∑ –∑–∞–≤–∏—Ç–∫–æ–º
üìÑ	—Å—Ç–æ—Ä—ñ–Ω–∫–∞ –ª–∏—Ü–µ–≤–æ—é —Å—Ç–æ—Ä–æ–Ω–æ—é	–¥–æ–∫—É–º–µ–Ω—Ç|—Å—Ç–æ—Ä—ñ–Ω–∫–∞|—Å—Ç–æ—Ä—ñ–Ω–∫–∞ –ª–∏—Ü–µ–≤–æ—é —Å—Ç–æ—Ä–æ–Ω–æ—é
üìÖ	–∫–∞–ª–µ–Ω–¥–∞—Ä	–≤—ñ–¥—Ä–∏–≤–Ω–∏–π –∫–∞–ª–µ–Ω–¥–∞—Ä|–¥–∞—Ç–∞|–∫–∞–ª–µ–Ω–¥–∞—Ä
üìÜ	–≤—ñ–¥—Ä–∏–≤–Ω–∏–π –∫–∞–ª–µ–Ω–¥–∞—Ä	–≤—ñ–¥—Ä–∏–≤–Ω–∏–π –∫–∞–ª–µ–Ω–¥–∞—Ä|–∫–∞–ª–µ–Ω–¥–∞—Ä
üìá	–∫–∞—Ä—Ç–æ—Ç–µ–∫–∞	—ñ–Ω–¥–µ–∫—Å|–∫–∞—Ä—Ç–æ—Ç–µ–∫–∞|—É–∫–∞–∑—ñ–≤–Ω–∏–∫
üìà	–≤–∏—Å—Ö—ñ–¥–Ω–∏–π –≥—Ä–∞—Ñ—ñ–∫	–≤–≥–æ—Ä—É|–≤–∏—Å—Ö—ñ–¥–Ω–∞ –¥—ñ–∞–≥—Ä–∞–º–∞|–≤–∏—Å—Ö—ñ–¥–Ω–∏–π –≥—Ä–∞—Ñ—ñ–∫|–≥—Ä–∞—Ñ—ñ–∫|–≥—Ä–∞—Ñ—ñ–∫ –ø—ñ–¥–≤–∏—â–µ–Ω–Ω—è|–¥—ñ–∞–≥—Ä–∞–º–∞|—Ä—ñ—Å—Ç|—Ç–µ–Ω–¥–µ–Ω—Ü—ñ—è
üìâ	–Ω–∏–∑—Ö—ñ–¥–Ω–∏–π –≥—Ä–∞—Ñ—ñ–∫	–≤–Ω–∏–∑|–≥—Ä–∞—Ñ—ñ–∫|–≥—Ä–∞—Ñ—ñ–∫ –ø–∞–¥—ñ–Ω–Ω—è|–¥—ñ–∞–≥—Ä–∞–º–∞|–Ω–∏–∑—Ö—ñ–¥–Ω–∞ –¥—ñ–∞–≥—Ä–∞–º–∞|–Ω–∏–∑—Ö—ñ–¥–Ω–∏–π –≥—Ä–∞—Ñ—ñ–∫|—Ç–µ–Ω–¥–µ–Ω—Ü—ñ—è
üìä	–≥—ñ—Å—Ç–æ–≥—Ä–∞–º–∞	–≥—ñ—Å—Ç–æ–≥—Ä–∞–º–∞|–≥—Ä–∞—Ñ—ñ–∫
üìã	–ø–ª–∞–Ω—à–µ—Ç –¥–ª—è –∞—Ä–∫—É—à—ñ–≤	–ø–∞–ø–∫–∞|–ø–∞–ø–∫–∞-–ø–ª–∞–Ω—à–µ—Ç|–ø–ª–∞–Ω—à–µ—Ç|–ø–ª–∞–Ω—à–µ—Ç –¥–ª—è –∞—Ä–∫—É—à—ñ–≤
üìå	–∫–∞–Ω—Ü–µ–ª—è—Ä—Å—å–∫–∞ –∫–Ω–æ–ø–∫–∞	–∫–∞–Ω—Ü–µ–ª—è—Ä—Å—å–∫–∞ –∫–Ω–æ–ø–∫–∞|–∫–Ω–æ–ø–∫–∞
üìç	—à–ø–∏–ª—å–∫–∞ –∑ –∫—Ä—É–≥–ª–æ—é –≥–æ–ª—ñ–≤–∫–æ—é	–∫–∞–Ω—Ü–µ–ª—è—Ä—Å—å–∫–∏–π|–∫–Ω–æ–ø–∫–∞|–∫—Ä—É–≥–ª–∏–π|–ª–æ–ª—ñ–ø–æ–ø|–ø—ñ–Ω|—à–ø–∏–ª—å–∫–∞
üìé	—Å–∫—Ä—ñ–ø–∫–∞	–∫–∞–Ω—Ü—Ç–æ–≤–∞—Ä–∏|—Å–∫—Ä—ñ–ø–∫–∞
üìè	–ø—Ä—è–º–∞ –ª—ñ–Ω—ñ–π–∫–∞	–≥–µ–æ–º–µ—Ç—Ä—ñ—è|–ª—ñ–Ω—ñ–π–∫–∞|–ø—Ä—è–º–∞ –ª—ñ–Ω—ñ–π–∫–∞|–ø—Ä—è–º–∏–π –∫—É—Ç
üìê	—Ç—Ä–∏–∫—É—Ç–Ω–∞ –ª—ñ–Ω—ñ–π–∫–∞	–ª—ñ–Ω—ñ–π–∫–∞|—Ç—Ä–∏–∫—É—Ç–Ω–∞ –ª—ñ–Ω—ñ–π–∫–∞|—Ç—Ä–∏–∫—É—Ç–Ω–∏–∫
üìë	–º—ñ—Ç–∫–∏ –∑–∞–∫–ª–∞–¥–æ–∫	–≤–∫–ª–∞–¥–∫–∞|–∑–∞–∫–ª–∞–¥–∫–∞|–∑–∞–∫–ª–∞–¥–∫–∏|–∑–Ω–∞—á–æ–∫|–º—ñ—Ç–∫–∞|–º—ñ—Ç–∫–∏ –∑–∞–∫–ª–∞–¥–æ–∫|—Å—Ç—ñ–∫–µ—Ä–∏
üìí	–≥—Ä–æ—Å–±—É—Ö	–≥—Ä–æ—Å–±—É—Ö|–∂—É—Ä–Ω–∞–ª|–∑–∞–ø–∏—Å–Ω–∏–∫|—Ä–µ—î—Å—Ç—Ä
üìì	–∑–æ—à–∏—Ç –¥–ª—è —Ç–≤–æ—Ä—ñ–≤	–±–ª–æ–∫–Ω–æ—Ç|–∑–∞–ø–∏—Å–Ω–∏–∫|–∑–æ—à–∏—Ç –¥–ª—è —Ç–≤–æ—Ä—ñ–≤
üìî	–∑–∞–ø–∏—Å–Ω–∏–∫ —É –¥–µ–∫–æ—Ä–∞—Ç–∏–≤–Ω—ñ–π –æ–±–∫–ª–∞–¥–∏–Ω—Ü—ñ	–¥–µ–∫–æ—Ä–∞—Ç–∏–≤–Ω–∞|–∑–∞–ø–∏—Å–Ω–∏–∫|–∑–∞–ø–∏—Å–Ω–∏–∫ —É –¥–µ–∫–æ—Ä–∞—Ç–∏–≤–Ω—ñ–π –æ–±–∫–ª–∞–¥–∏–Ω—Ü—ñ|–∫–Ω–∏–∂–∫–∞|–æ–±–∫–ª–∞–¥–∏–Ω–∫–∞
üìï	–∑–∞–∫—Ä–∏—Ç–∞ –∫–Ω–∏–≥–∞	–∂—É—Ä–Ω–∞–ª|–∑–∞–∫—Ä–∏—Ç–∞|–∑–∞–∫—Ä–∏—Ç–∞ –∫–Ω–∏–≥–∞|–∫–Ω–∏–∂–∫–∞|—á–µ—Ä–≤–æ–Ω–∞ –∫–Ω–∏–≥–∞|—á–µ—Ä–≤–æ–Ω–∏–π –ø—ñ–¥—Ä—É—á–Ω–∏–∫
üìñ	–≤—ñ–¥–∫—Ä–∏—Ç–∞ –∫–Ω–∏–≥–∞	–≤—ñ–¥–∫—Ä–∏—Ç–∞|–≤—ñ–¥–∫—Ä–∏—Ç–∞ –∫–Ω–∏–≥–∞|–∫–Ω–∏–∂–∫–∞|—á–∏—Ç–∞—Ç–∏
üìó	–∑–µ–ª–µ–Ω–∏–π –ø—ñ–¥—Ä—É—á–Ω–∏–∫	–∂—É—Ä–Ω–∞–ª|–∑–µ–ª–µ–Ω–∞ –∫–Ω–∏–≥–∞|–∑–µ–ª–µ–Ω–∏–π|–∑–µ–ª–µ–Ω–∏–π –ø—ñ–¥—Ä—É—á–Ω–∏–∫|–∫–Ω–∏–∂–∫–∞|–æ–±–ª—ñ–∫
üìò	—Å–∏–Ω—ñ–π –ø—ñ–¥—Ä—É—á–Ω–∏–∫	–∫–Ω–∏–∂–∫–∞|—Å–∏–Ω—ñ–π|—Å–∏–Ω—ñ–π –ø—ñ–¥—Ä—É—á–Ω–∏–∫|—Å–∏–Ω—è –∫–Ω–∏–≥–∞
üìô	–æ—Ä–∞–Ω–∂–µ–≤–∏–π –ø—ñ–¥—Ä—É—á–Ω–∏–∫	–∫–Ω–∏–∂–∫–∞|–æ—Ä–∞–Ω–∂–µ–≤–∞ –∫–Ω–∏–≥–∞|–æ—Ä–∞–Ω–∂–µ–≤–∏–π|–æ—Ä–∞–Ω–∂–µ–≤–∏–π –ø—ñ–¥—Ä—É—á–Ω–∏–∫
üìö	–∫–Ω–∏–≥–∏	–±—ñ–±–ª—ñ–æ—Ç–µ–∫–∞|–∫–Ω–∏–≥–∞—Ä–Ω—è|–∫–Ω–∏–≥–∏|–∫–Ω–∏–∂–∫–∞|–∫–Ω–∏–∂–∫–∏
üìõ	–±–µ–π–¥–∂ –∑ —ñ–º–µ–Ω–µ–º	–±–µ–π–¥–∂|–±–µ–π–¥–∂ –∑ —ñ–º–µ–Ω–µ–º|—ñ–º‚Äô—è
üìú	—Å—É–≤—ñ–π	–ø–∞–ø—ñ—Ä|–ø–∞–ø—ñ—Ä—É—Å|—Ä—É–∫–æ–ø–∏—Å|—Å—É–≤—ñ–π
üìù	–ø–∞–º º—è—Ç–∫–∞	–Ω–æ—Ç–∞—Ç–∫–∞|–Ω–æ—Ç–∞—Ç–∫–∏|–æ–ª—ñ–≤–µ—Ü—å|–ø–∞–º º—è—Ç–∫–∞
üìû	—Ç–µ–ª–µ—Ñ–æ–Ω–Ω–∞ —Å–ª—É—Ö–∞–≤–∫–∞	—Å–ª—É—Ö–∞–≤–∫–∞|—Ç–µ–ª–µ—Ñ–æ–Ω|—Ç–µ–ª–µ—Ñ–æ–Ω–Ω–∞ —Ä–æ–∑–º–æ–≤–∞|—Ç–µ–ª–µ—Ñ–æ–Ω–Ω–∞ —Å–ª—É—Ö–∞–≤–∫–∞
üìü	–ø–µ–π–¥–∂–µ—Ä	–ø–µ–π–¥–∂–µ—Ä
üì†	—Ñ–∞–∫—Å	—Ç–µ–ª–µ—Ñ–∞–∫—Å|—Ñ–∞–∫—Å–∏–º—ñ–ª—å–Ω–∏–π –∞–ø–∞—Ä–∞—Ç
üì°	—Å—É–ø—É—Ç–Ω–∏–∫–æ–≤–∞ –∞–Ω—Ç–µ–Ω–∞	–∞–Ω—Ç–µ–Ω–∞|—Å—É–ø—É—Ç–Ω–∏–∫–æ–≤–∞|—Ç–∞—Ä—ñ–ª–∫–∞
üì¢	–≥—É—á–Ω–æ–º–æ–≤–µ—Ü—å	–≥–æ–ª–æ—Å–Ω–æ|–≥—É—á–Ω–∏–π|–≥—É—á–Ω–æ–º–æ–≤–µ—Ü—å|–∑–≤—É–∫–æ–≤–µ –æ–ø–æ–≤—ñ—â–µ–Ω–Ω—è
üì£	–º–µ–≥–∞—Ñ–æ–Ω	–º–µ–≥–∞—Ñ–æ–Ω|–æ–≥–æ–ª–æ—à–µ–Ω–Ω—è|–ø—ñ–¥–±–∞–¥—å–æ—Ä–µ–Ω–Ω—è|—Ä—É–ø–æ—Ä
üì§	–ª–æ—Ç–æ–∫ –≤–∏—Ö—ñ–¥–Ω–æ—ó —Å–∫—Ä–∏–Ω—å–∫–∏	–µ–ª–µ–∫—Ç—Ä–æ–Ω–Ω–∏–π –ª–∏—Å—Ç|–∫–æ—Ä–æ–±–∫–∞|–ª–∏—Å—Ç|–ª–æ—Ç–æ–∫|–ª–æ—Ç–æ–∫ –≤–∏—Ö—ñ–¥–Ω–æ—ó —Å–∫—Ä–∏–Ω—å–∫–∏|–ª–æ—Ç–æ–∫ –¥–ª—è –≤–∏—Ö—ñ–¥–Ω–æ—ó –ø–æ—à—Ç–∏|–Ω–∞–¥—ñ—Å–ª–∞–Ω–∏–π|–ø–æ—à—Ç–∞
üì•	–ª–æ—Ç–æ–∫ –≤—Ö—ñ–¥–Ω–æ—ó —Å–∫—Ä–∏–Ω—å–∫–∏	–≤—Ö—ñ–¥–Ω–∞ –ø–æ—à—Ç–∞|–∫–æ—Ä–æ–±–∫–∞|–ª–∏—Å—Ç|–ª–æ—Ç–æ–∫|–ª–æ—Ç–æ–∫ –≤—Ö—ñ–¥–Ω–æ—ó —Å–∫—Ä–∏–Ω—å–∫–∏|–ª–æ—Ç–æ–∫ –¥–ª—è –≤—Ö—ñ–¥–Ω–æ—ó –ø–æ—à—Ç–∏|–æ—Ç—Ä–∏–º—É–≤–∞—Ç–∏|–ø–æ—à—Ç–∞
üì¶	–ø–∞–∫—É–Ω–æ–∫	–ø–∞–∫—É–Ω–æ–∫|–ø–æ—Å–∏–ª–∫–∞
üìß	–µ–ª–µ–∫—Ç—Ä–æ–Ω–Ω–∏–π –ª–∏—Å—Ç	–µ–ª–µ–∫—Ç—Ä–æ–Ω–Ω–∏–π –ª–∏—Å—Ç|–µ–ª–∏—Å—Ç|–µ–º–µ–π–ª|–µ–ø–æ—à—Ç–∞|—ñ–º–µ–π–ª|–ª–∏—Å—Ç|–ø–æ—à—Ç–∞
üì®	–∫–æ–Ω–≤–µ—Ä—Ç –≤—Ö—ñ–¥–Ω–æ–≥–æ –ª–∏—Å—Ç–∞	–≤—Ö—ñ–¥–Ω–∏–π|–µ–º–µ–π–ª|—ñ–º–µ–π–ª|–∫–æ–Ω–≤–µ—Ä—Ç|–∫–æ–Ω–≤–µ—Ä—Ç –≤—Ö—ñ–¥–Ω–æ–≥–æ –ª–∏—Å—Ç–∞|–ª–∏—Å—Ç|–æ—Ç—Ä–∏–º–∞—Ç–∏|–ø–æ—à—Ç–∞
üì©	–∫–æ–Ω–≤–µ—Ä—Ç –∑—ñ —Å—Ç—Ä—ñ–ª–∫–æ—é	–≤–∏—Ö—ñ–¥–Ω–∏–π|–≤–Ω–∏–∑|–≤—Ö—ñ–¥–Ω–∞ –ø–æ—à—Ç–∞|–≤—Ö—ñ–¥–Ω–∏–π —ñ–º–µ–π–ª|—ñ–º–µ–π–ª|–∫–æ–Ω–≤–µ—Ä—Ç|–∫–æ–Ω–≤–µ—Ä—Ç –∑—ñ —Å—Ç—Ä—ñ–ª–∫–æ—é|–ª–∏—Å—Ç|–Ω–∞–¥—ñ—Å–ª–∞–Ω–∏–π|–ø–æ—à—Ç–∞|—Å—Ç—Ä—ñ–ª–∫–∞
üì™	–∑–∞–∫—Ä–∏—Ç–∞ –ø–æ—à—Ç–æ–≤–∞ —Å–∫—Ä–∏–Ω—å–∫–∞ –∑ –æ–ø—É—â–µ–Ω–∏–º –ø—Ä–∞–ø–æ—Ä—Ü–µ–º	–∑–∞–∫—Ä–∏—Ç–∞ –ø–æ—à—Ç–æ–≤–∞ —Å–∫—Ä–∏–Ω—å–∫–∞ –∑ –æ–ø—É—â–µ–Ω–∏–º –ø—Ä–∞–ø–æ—Ä—Ü–µ–º|–∑–∞–∫—Ä–∏—Ç–∏–π|–æ–ø—É—â–µ–Ω–∏–π|–ø–æ—à—Ç–∞|–ø–æ—à—Ç–æ–≤–∞ —Å–∫—Ä–∏–Ω—å–∫–∞
üì´	–∑–∞–∫—Ä–∏—Ç–∞ –ø–æ—à—Ç–æ–≤–∞ —Å–∫—Ä–∏–Ω—å–∫–∞ –∑ –ø—ñ–¥–Ω—è—Ç–∏–º –ø—Ä–∞–ø–æ—Ä—Ü–µ–º	–∑–∞–∫—Ä–∏—Ç–∞ –ø–æ—à—Ç–æ–≤–∞ —Å–∫—Ä–∏–Ω—å–∫–∞ –∑ –ø—ñ–¥–Ω—è—Ç–∏–º –ø—Ä–∞–ø–æ—Ä—Ü–µ–º|–∑–∞–∫—Ä–∏—Ç–∏–π|–ø–æ—à—Ç–∞|–ø–æ—à—Ç–æ–≤–∞ —Å–∫—Ä–∏–Ω—å–∫–∞
üì¨	–≤—ñ–¥–∫—Ä–∏—Ç–∞ –ø–æ—à—Ç–æ–≤–∞ —Å–∫—Ä–∏–Ω—å–∫–∞ –∑ –ø—ñ–¥–Ω—è—Ç–∏–º –ø—Ä–∞–ø–æ—Ä—Ü–µ–º	–≤—ñ–¥–∫—Ä–∏—Ç–∞ –ø–æ—à—Ç–æ–≤–∞ —Å–∫—Ä–∏–Ω—å–∫–∞ –∑ –ø—ñ–¥–Ω—è—Ç–∏–º –ø—Ä–∞–ø–æ—Ä—Ü–µ–º|–≤—ñ–¥–∫—Ä–∏—Ç–∏–π|–ø–æ—à—Ç–∞|–ø–æ—à—Ç–æ–≤–∞ —Å–∫—Ä–∏–Ω—å–∫–∞
üì≠	–≤—ñ–¥–∫—Ä–∏—Ç–∞ –ø–æ—à—Ç–æ–≤–∞ —Å–∫—Ä–∏–Ω—å–∫–∞ –∑ –æ–ø—É—â–µ–Ω–∏–º –ø—Ä–∞–ø–æ—Ä—Ü–µ–º	–≤—ñ–¥–∫—Ä–∏—Ç–∞ –ø–æ—à—Ç–æ–≤–∞ —Å–∫—Ä–∏–Ω—å–∫–∞|–≤—ñ–¥–∫—Ä–∏—Ç–∞ –ø–æ—à—Ç–æ–≤–∞ —Å–∫—Ä–∏–Ω—å–∫–∞ –∑ –æ–ø—É—â–µ–Ω–∏–º –ø—Ä–∞–ø–æ—Ä—Ü–µ–º|–≤—ñ–¥–∫—Ä–∏—Ç–∏–π|–æ–ø—É—â–µ–Ω–∏–π|–ø–æ—à—Ç–∞|–ø–æ—à—Ç–æ–≤–∞ —Å–∫—Ä–∏–Ω—å–∫–∞|–ø—É—Å—Ç–∞ –ø–æ—à—Ç–æ–≤–∞ —Å–∫—Ä–∏–Ω—å–∫–∞
üìÆ	–ø–æ—à—Ç–æ–≤–∞ —Å–∫—Ä–∏–Ω—å–∫–∞	–ø–æ—à—Ç–∞|–ø–æ—à—Ç–æ–≤–∞ —Å–∫—Ä–∏–Ω—å–∫–∞|—Å–∫—Ä–∏–Ω—å–∫–∞
üìØ	–ø–æ—à—Ç–æ–≤–∏–π —Ä—ñ–∂–æ–∫	–ø–æ—à—Ç–∞|–ø–æ—à—Ç–æ–≤–∏–π|—Ä—ñ–∂–æ–∫
üì∞	–≥–∞–∑–µ—Ç–∞	–≥–∞–∑–µ—Ç–∞|–Ω–æ–≤–∏–Ω–∏|–ø–∞–ø—ñ—Ä|—à–ø–∞–ª—å—Ç–∞
üì±	–º–æ–±—ñ–ª—å–Ω–∏–π —Ç–µ–ª–µ—Ñ–æ–Ω	–º–æ–±—ñ–ª—å–Ω–∏–π|—Å—Ç—ñ–ª—å–Ω–∏–∫–æ–≤–∏–π|—Å—Ç—ñ–ª—å–Ω–∏–∫–æ–≤–∏–π –∑–≤ º—è–∑–æ–∫|—Ç–µ–ª–µ—Ñ–æ–Ω
üì≤	–º–æ–±—ñ–ª—å–Ω–∏–π —Ç–µ–ª–µ—Ñ–æ–Ω –∑—ñ —Å—Ç—Ä—ñ–ª–∫–æ—é	–≤—Ö—ñ–¥–Ω–∏–π –¥–∑–≤—ñ–Ω–æ–∫|–¥–æ—Å—Ç—É–ø–Ω–∏–π –Ω–∞ –º–æ–±—ñ–ª—å–Ω–æ–º—É|–∑–∞—Ç–µ–ª–µ—Ñ–æ–Ω—É–π –º–µ–Ω—ñ|–º–æ–±—ñ–ª—å–Ω–∏–π|–º–æ–±—ñ–ª—å–Ω–∏–π —Ç–µ–ª–µ—Ñ–æ–Ω –∑—ñ —Å—Ç—Ä—ñ–ª–∫–æ—é|–æ—Ç—Ä–∏–º—É–≤–∞—Ç–∏|—Å—Ç—ñ–ª—å–Ω–∏–∫–æ–≤–∏–π|—Å—Ç—Ä—ñ–ª–∫–∞|—Ç–µ–ª–µ—Ñ–æ–Ω|—Ç–µ–ª–µ—Ñ–æ–Ω—É–≤–∞—Ç–∏
üì≥	–≤—ñ–±—Ä–æ—Ä–µ–∂–∏–º	–≤—ñ–±—Ä–∞—Ü—ñ—è|–≤—ñ–±—Ä–æ—Ä–µ–∂–∏–º|–∑–≤ º—è–∑–æ–∫|–º–æ–±—ñ–ª—å–Ω–∏–π|—Ä–µ–∂–∏–º –≤—ñ–±—Ä–∞—Ü—ñ—ó|—Å—Ç—ñ–ª—å–Ω–∏–∫–æ–≤–∏–π|—Ç–µ–ª–µ—Ñ–æ–Ω
üì¥	–º–æ–±—ñ–ª—å–Ω–∏–π —Ç–µ–ª–µ—Ñ–æ–Ω –≤–∏–º–∫–Ω–µ–Ω–æ	–≤–∏–º–∫–Ω–µ–Ω–æ|–º–æ–±—ñ–ª—å–Ω–∏–π|—Å—Ç—ñ–ª—å–Ω–∏–∫–æ–≤–∏–π|—Ç–µ–ª–µ—Ñ–æ–Ω
üìµ	–º–æ–±—ñ–ª—å–Ω—ñ —Ç–µ–ª–µ—Ñ–æ–Ω–∏ –∑–∞–±–æ—Ä–æ–Ω–µ–Ω–æ	–∑–∞–±–æ—Ä–æ–Ω–µ–Ω–æ|–∫–æ—Ä–∏—Å—Ç—É–≤–∞—Ç–∏—Å—è|–º–æ–±—ñ–ª—å–Ω–∏–π|–º–æ–±—ñ–ª—å–Ω—ñ —Ç–µ–ª–µ—Ñ–æ–Ω–∏ –∑–∞–±–æ—Ä–æ–Ω–µ–Ω—ñ|–º–æ–±—ñ–ª—å–Ω—ñ —Ç–µ–ª–µ—Ñ–æ–Ω–∏ –∑–∞–±–æ—Ä–æ–Ω–µ–Ω–æ|—Å—Ç—ñ–ª—å–Ω–∏–∫–æ–≤–∏–π|—Ç–µ–ª–µ—Ñ–æ–Ω
üì∂	—Ä—ñ–≤–µ–Ω—å —Å–∏–≥–Ω–∞–ª—É	–º–æ–±—ñ–ª—å–Ω–∏–π|—Ä—ñ–≤–µ–Ω—å|—Ä—ñ–≤–µ–Ω—å —Å–∏–≥–Ω–∞–ª—É|—Å–∏–≥–Ω–∞–ª|—Å—Ç—ñ–ª—å–Ω–∏–∫–æ–≤–∏–π|—Ç–µ–ª–µ—Ñ–æ–Ω
üì∑	—Ñ–æ—Ç–æ–∞–ø–∞—Ä–∞—Ç	–≤—ñ–¥–µ–æ|–∑–Ω—ñ–º–∫–∏|–∫–∞–º–µ—Ä–∞|–Ω–∞ –∑–≥–∞–¥–∫—É|—Ñ–æ—Ç–æ|—Ñ–æ—Ç–æ–∞–ø–∞—Ä–∞—Ç|—Ñ–æ—Ç–æ–≥—Ä–∞—Ñ
üì∏	—Ñ–æ—Ç–æ–∞–ø–∞—Ä–∞—Ç –∑—ñ —Å–ø–∞–ª–∞—Ö–æ–º	–≤—ñ–¥–µ–æ|–∫–∞–º–µ—Ä–∞|—Å–ø–∞–ª–∞—Ö|—Ñ–æ—Ç–æ|—Ñ–æ—Ç–æ–∞–ø–∞—Ä–∞—Ç –∑—ñ —Å–ø–∞–ª–∞—Ö–æ–º
üìπ	–≤—ñ–¥–µ–æ–∫–∞–º–µ—Ä–∞	–≤—ñ–¥–µ–æ|–≤—ñ–¥–µ–æ–∫–∞–º–µ—Ä–∞|–∫–∞–º–µ—Ä–∞
üì∫	—Ç–µ–ª–µ–≤—ñ–∑–æ—Ä	TV|–≤—ñ–¥–µ–æ|—Ç–±|—Ç–µ–ª–µ–≤—ñ–∑–æ—Ä|—á–æ—Ä–Ω–æ-–±—ñ–ª–∏–π —Ç–µ–ª–µ–≤—ñ–∑–æ—Ä
üìª	—Ä–∞–¥—ñ–æ–ø—Ä–∏–π–º–∞—á	–≤—ñ–¥–µ–æ|—Ä–∞–¥—ñ–æ|—Ä–∞–¥—ñ–æ–ø—Ä–∏–π–º–∞—á
üìº	–≤—ñ–¥–µ–æ–∫–∞—Å–µ—Ç–∞	–≤—ñ–¥–µ–æ|–≤—ñ–¥–µ–æ–∫–∞—Å–µ—Ç–∞|–∫–∞—Å–µ—Ç–∞|—Å—Ç—Ä—ñ—á–∫–∞
üìø	–º–æ–ª–∏—Ç–æ–≤–Ω—ñ —á–æ—Ç–∫–∏	–≤–µ—Ä–≤–∏—Ü—è|–º–æ–ª–∏—Ç–∏—Å—è|–º–æ–ª–∏—Ç–æ–≤–Ω—ñ —á–æ—Ç–∫–∏|–Ω–∞–º–∏—Å—Ç–æ|–æ–¥—è–≥|—Ä–µ–ª—ñ–≥—ñ—è|—á–æ—Ç–∫–∏
üîÄ	–∫–Ω–æ–ø–∫–∞ —Ç–∞—Å—É–≤–∞–Ω–Ω—è –∫–æ–º–ø–æ–∑–∏—Ü—ñ–π	–∫–Ω–æ–ø–∫–∞ ¬´–ó–º—ñ—à–∞—Ç–∏ –∫–æ–º–ø–æ–∑–∏—Ü—ñ—ó¬ª|–∫–Ω–æ–ø–∫–∞ —Ç–∞—Å—É–≤–∞–Ω–Ω—è –∫–æ–º–ø–æ–∑–∏—Ü—ñ–π|–ø–µ—Ä–µ—Ö—Ä–µ—â–µ–Ω—ñ|–ø–µ—Ä–µ—Ö—Ä–µ—â–µ–Ω—ñ —Å—Ç—Ä—ñ–ª–∫–∏|—Å—Ç—Ä—ñ–ª–∫–∞
üîÅ	–∫–Ω–æ–ø–∫–∞ –ø–æ–≤—Ç–æ—Ä—É	–∑–∞ –≥–æ–¥–∏–Ω–Ω–∏–∫–æ–≤–æ—é —Å—Ç—Ä—ñ–ª–∫–æ—é|–∫–Ω–æ–ø–∫–∞ ¬´–ü–æ–≤—Ç–æ—Ä–∏—Ç–∏¬ª|–∫–Ω–æ–ø–∫–∞ –ø–æ–≤—Ç–æ—Ä—É|–ø–æ–≤—Ç–æ—Ä–∏—Ç–∏|—Å—Ç—Ä—ñ–ª–∫–∞
üîÇ	–∫–Ω–æ–ø–∫–∞ –æ–¥–Ω–æ—Ä–∞–∑–æ–≤–æ–≥–æ –ø–æ–≤—Ç–æ—Ä—É	–∑–∞ –≥–æ–¥–∏–Ω–Ω–∏–∫–æ–≤–æ—é —Å—Ç—Ä—ñ–ª–∫–æ—é|–∫–Ω–æ–ø–∫–∞ ¬´–ü–æ–≤—Ç–æ—Ä–∏—Ç–∏ –æ–¥–Ω—É –∫–æ–º–ø–æ–∑–∏—Ü—ñ—é¬ª|–∫–Ω–æ–ø–∫–∞ –æ–¥–Ω–æ—Ä–∞–∑–æ–≤–æ–≥–æ –ø–æ–≤—Ç–æ—Ä—É|–æ–¥–∏–Ω —Ä–∞–∑|—Å—Ç—Ä—ñ–ª–∫–∞
üîÉ	–≤–µ—Ä—Ç–∏–∫–∞–ª—å–Ω—ñ —Å—Ç—Ä—ñ–ª–∫–∏ –∑–∞ —Ö–æ–¥–æ–º –≥–æ–¥–∏–Ω–Ω–∏–∫–∞	–≤–µ—Ä—Ç–∏–∫–∞–ª—å–Ω—ñ —Å—Ç—Ä—ñ–ª–∫–∏ –∑–∞ —Ö–æ–¥–æ–º –≥–æ–¥–∏–Ω–Ω–∏–∫–∞|–∑–∞ –≥–æ–¥–∏–Ω–Ω–∏–∫–æ–≤–æ—é —Å—Ç—Ä—ñ–ª–∫–æ—é|–æ–Ω–æ–≤–∏—Ç–∏|–ø–µ—Ä–µ–∑–∞–≤–∞–Ω—Ç–∞–∂–µ–Ω–Ω—è|–ø–µ—Ä–µ–∑–∞–≤–∞–Ω—Ç–∞–∂–∏—Ç–∏|—Å—Ç—Ä—ñ–ª–∫–∞|—Å—Ç—Ä—ñ–ª–∫–∏ –ø–æ –∫–æ–ª—É –∑–∞ –≥–æ–¥–∏–Ω–Ω–∏–∫–æ–≤–æ—é —Å—Ç—Ä—ñ–ª–∫–æ—é
üîÑ	–∫–Ω–æ–ø–∫–∞ —Å—Ç—Ä—ñ–ª–æ–∫ –ø—Ä–æ—Ç–∏ —Ö–æ–¥—É –≥–æ–¥–∏–Ω–Ω–∏–∫–∞	–∫–Ω–æ–ø–∫–∞ –∑—ñ —Å—Ç—Ä—ñ–ª–∫–∞–º–∏|–∫–Ω–æ–ø–∫–∞ —Å—Ç—Ä—ñ–ª–æ–∫ –ø—Ä–æ—Ç–∏ —Ö–æ–¥—É –≥–æ–¥–∏–Ω–Ω–∏–∫–∞|–Ω–∞–≤–∫—Ä—É–≥–∏|–Ω–∞–ø—Ä—è–º–ª–µ–Ω–∏–º–∏ –ø—Ä–æ—Ç–∏ –≥–æ–¥–∏–Ω–Ω–∏–∫–æ–≤–æ—ó —Å—Ç—Ä—ñ–ª–∫–∏|–ø—Ä–æ—Ç–∏ –≥–æ–¥–∏–Ω–Ω–∏–∫–æ–≤–æ—ó —Å—Ç—Ä—ñ–ª–∫–∏|—Å—Ç—Ä—ñ–ª–∫–∞
üîÖ	–∫–Ω–æ–ø–∫–∞ –∑–º–µ–Ω—à–µ–Ω–Ω—è —è—Å–∫—Ä–∞–≤–æ—Å—Ç—ñ	–∂–æ–≤—Ç–∏–π|–∑–º–µ–Ω—à–∏—Ç–∏|–∫–Ω–æ–ø–∫–∞ –∑–º–µ–Ω—à–µ–Ω–Ω—è —è—Å–∫—Ä–∞–≤–æ—Å—Ç—ñ|—Å–æ–Ω—Ü–µ|—è—Å–∫—Ä–∞–≤–∏–π|—è—Å–∫—Ä–∞–≤—ñ—Å—Ç—å|—è—Å–∫—Ä–∞–≤–æ
üîÜ	–∫–Ω–æ–ø–∫–∞ –∑–±—ñ–ª—å—à–µ–Ω–Ω—è —è—Å–∫—Ä–∞–≤–æ—Å—Ç—ñ	–∫–Ω–æ–ø–∫–∞ –∑–±—ñ–ª—å—à–µ–Ω–Ω—è —è—Å–∫—Ä–∞–≤–æ—Å—Ç—ñ|—è—Å–∫—Ä–∞–≤–∏–π|—è—Å–∫—Ä–∞–≤—ñ—Å—Ç—å
üîá	–∑–∞–≥–ª—É—à–µ–Ω–∏–π –¥–∏–Ω–∞–º—ñ–∫	–±–µ–∑–∑–≤—É—á–Ω–∏–π|–±–µ–∑–∑–≤—É—á–Ω–æ|–≤–∏–º–∫–Ω–µ–Ω–∏–π –¥–∏–Ω–∞–º—ñ–∫|–≤–∏–º–∫–Ω–µ–Ω–∏–π –∑–≤—É–∫|–≥—É—á–Ω—ñ—Å—Ç—å|–¥–∏–Ω–∞–º—ñ–∫|–∑–∞–≥–ª—É—à–µ–Ω–∏–π –¥–∏–Ω–∞–º—ñ–∫|–∑–≤—É–∫ –¥–∏–Ω–∞–º—ñ–∫–∞ –≤–∏–º–∫–Ω–µ–Ω–æ|–Ω–µ—á—É—Ç–Ω–æ|—Ç–∏—Ö–æ
üîà	–Ω–∏–∑—å–∫–∞ –≥—É—á–Ω—ñ—Å—Ç—å –¥–∏–Ω–∞–º—ñ–∫–∞	–≥–æ–ª–æ—Å–Ω–æ|–≥—É—á–Ω—ñ—Å—Ç—å|–¥–∏–Ω–∞–º—ñ–∫|–Ω–µ–≥—É—á–Ω–æ|–Ω–∏–∑—å–∫–∞ –≥—É—á–Ω—ñ—Å—Ç—å –¥–∏–Ω–∞–º—ñ–∫–∞|–ø—Ä–∏–≥–ª—É—à–µ–Ω–æ
üîâ	—Å–µ—Ä–µ–¥–Ω—è –≥—É—á–Ω—ñ—Å—Ç—å –¥–∏–Ω–∞–º—ñ–∫–∞	–≥—É—á–Ω—ñ—Å—Ç—å|–¥–∏–Ω–∞–º—ñ–∫|—Å–µ—Ä–µ–¥–Ω—å–æ|—Å–µ—Ä–µ–¥–Ω—è –≥—É—á–Ω—ñ—Å—Ç—å –¥–∏–Ω–∞–º—ñ–∫–∞|—É–≤—ñ–º–∫–Ω–µ–Ω–∏–π –¥–∏–Ω–∞–º—ñ–∫
üîä	–≤–∏—Å–æ–∫–∏–π —Ä—ñ–≤–µ–Ω—å –≥—É—á–Ω–æ—Å—Ç—ñ –¥–∏–Ω–∞–º—ñ–∫–∞	–≤–∏—Å–æ–∫–∞ –≥—É—á–Ω—ñ—Å—Ç—å –¥–∏–Ω–∞–º—ñ–∫–∞|–≤–∏—Å–æ–∫–∏–π —Ä—ñ–≤–µ–Ω—å –≥—É—á–Ω–æ—Å—Ç—ñ –¥–∏–Ω–∞–º—ñ–∫–∞|–≥–æ–ª–æ—Å–Ω–æ|–≥—É—á–Ω–∏–π|–≥—É—á–Ω—ñ—Å—Ç—å|–≥—É—á–Ω–æ|–≥—É—á–Ω–æ–º–æ–≤–µ—Ü—å|–¥–∏–Ω–∞–º—ñ–∫|–º—É–∑–∏–∫–∞
üîã	–±–∞—Ç–∞—Ä–µ—è	–∞–∫—É–º—É–ª—è—Ç–æ—Ä|–±–∞—Ç–∞—Ä–µ–π–∫–∞|–±–∞—Ç–∞—Ä–µ—è|–¥–∂–µ—Ä–µ–ª–æ –∂–∏–≤–ª–µ–Ω–Ω—è
üîå	—à—Ç–µ–ø—Å–µ–ª—å	–≤–∏–ª–∫–∞|–≤–∏–ª–∫–∞ –µ–ª–µ–∫—Ç—Ä–æ–ø—Ä–∏–ª–∞–¥—É|–µ–ª–µ–∫—Ç—Ä–∏–∫–∞|–µ–ª–µ–∫—Ç—Ä–∏—á–Ω–∏–π|—à—Ç–µ–ø—Å–µ–ª—å
üîç	–∑–±—ñ–ª—å—à—É–≤–∞–ª—å–Ω–µ —Å–∫–ª–æ –∑ –Ω–∞—Ö–∏–ª–æ–º —É–ª—ñ–≤–æ	–∑ –Ω–∞—Ö–∏–ª–æ–º —É–ª—ñ–≤–æ|–∑–±—ñ–ª—å—à–µ–Ω–Ω—è|—ñ–Ω—Å—Ç—Ä—É–º–µ–Ω—Ç|–ª–∞–±–æ—Ä–∞—Ç–æ—Ä—ñ—è|–Ω–∞—É–∫–∞|–Ω–∞—Ö–∏–ª–µ–Ω–∏–π|–ø–æ—à—É–∫|—Å–∫–ª–æ|—É–ª—ñ–≤–æ
üîé	–∑–±—ñ–ª—å—à—É–≤–∞–ª—å–Ω–µ —Å–∫–ª–æ –∑ –Ω–∞—Ö–∏–ª–æ–º —É–ø—Ä–∞–≤–æ	–∑–±—ñ–ª—å—à–µ–Ω–Ω—è|—ñ–Ω—Å—Ç—Ä—É–º–µ–Ω—Ç|–∫–æ–Ω—Ç–∞–∫—Ç|–ª–∞–±–æ—Ä–∞—Ç–æ—Ä—ñ—è|–Ω–∞—É–∫–∞|–Ω–∞—Ö–∏–ª —É–ø—Ä–∞–≤–æ|–Ω–∞—Ö–∏–ª–µ–Ω–∏–π|–ø–æ—à—É–∫|—Å–∫–ª–æ|—É–ø—Ä–∞–≤–æ
üîè	–∑–∞–º–æ–∫ —ñ —á–æ—Ä–Ω–∏–ª—å–Ω–∞ —Ä—É—á–∫–∞	–∑–∞–º–æ–∫|–∑–∞–º–æ–∫ —ñ —á–æ—Ä–Ω–∏–ª—å–Ω–∞ —Ä—É—á–∫–∞|–∫–æ–Ω—Ñ—ñ–¥–µ–Ω—Ü—ñ–π–Ω—ñ—Å—Ç—å|–ø–µ—Ä–æ|–ø—Ä–∏–≤–∞—Ç–Ω—ñ—Å—Ç—å|—Ä—É—á–∫–∞|—Å–µ–∫—Ä–µ—Ç–Ω—ñ –º–∞—Ç–µ—Ä—ñ–∞–ª–∏|—Ç–∞—î–º–Ω–æ|—á–æ—Ä–Ω–∏–ª–æ
üîê	–∑–∞–º–∫–Ω–µ–Ω–∏–π –∑–∞–º–æ–∫ —ñ–∑ –∫–ª—é—á–µ–º	–±–µ–∑–ø–µ–∫–∞|–±–µ–∑–ø–µ—á–Ω–æ|–∑–∞–º–∫–Ω–µ–Ω–∏–π –∑–∞–º–æ–∫ —ñ–∑ –∫–ª—é—á–µ–º|–∑–∞–º–∫–Ω–µ–Ω–æ|–∑–∞–º–æ–∫|–∫–ª—é—á
üîë	–∫–ª—é—á	–∫–ª—é—á|–ø–∞—Ä–æ–ª—å
üîí	–∑–∞–º–∫–Ω–µ–Ω–∏–π –∑–∞–º–æ–∫	–∑–∞–∫—Ä–∏—Ç–æ|–∑–∞–º–∫–Ω–µ–Ω–æ|–∑–∞–º–æ–∫|–∑–∞—Ö–∏—Å—Ç|–ø—Ä–∏–≤–∞—Ç–Ω—ñ—Å—Ç—å
üîì	–≤—ñ–¥—ñ–º–∫–Ω–µ–Ω–∏–π –∑–∞–º–æ–∫	–≤—ñ–¥—ñ–º–∫–Ω–µ–Ω–∏–π –∑–∞–º–æ–∫|–≤—ñ–¥—ñ–º–∫–Ω—É—Ç–∏|–≤—ñ–¥–∫—Ä–∏—Ç–∏|–≤—ñ–¥–∫—Ä–∏—Ç–∏–π –∑–∞–º–æ–∫|–≤—ñ–¥—Ä–∏—Ç–∏|–∑–∞–º–æ–∫
üîî	–¥–∑–≤—ñ–Ω–æ–∫	–¥–∑–≤—ñ–Ω|–¥–∑–≤—ñ–Ω–æ–∫|–¥–∑–≤–æ–Ω–∏–∫
üîï	–∑–∞–≥–ª—É—à–µ–Ω–∏–π –¥–∑–≤—ñ–Ω–æ–∫	–±–µ–∑–∑–≤—É—á–Ω–∏–π|–≤–∏–º–∫–Ω–µ–Ω–∏–π|–≥–ª—É—à–∏—Ç–∏|–¥–∑–≤—ñ–Ω–æ–∫|–¥–∑–≤–æ–Ω–∏–∫|–∑–∞–±–æ—Ä–æ–Ω–µ–Ω–æ|–∑–∞–≥–ª—É—à–µ–Ω–∏–π|–∑–≤—É–∫|–ø–µ—Ä–µ–∫—Ä–µ—Å–ª–µ–Ω–∏–π|—Ç–∏—Ö–∏–π
üîñ	–∑–∞–∫–ª–∞–¥–∫–∞	–±—ñ—Ä–∫–∞|–∑–∞–∫–ª–∞–¥–∫–∞|–∑–Ω–∞—á–æ–∫
üîó	—Å–∏–º–≤–æ–ª –∑ º—î–¥–Ω–∞–Ω–Ω—è –ª–∞–Ω–æ–∫	–∑–≤ º—è–∑–∫–∞|–ª–∞–Ω–∫–∞|–ª–∞–Ω—Ü—é–≥|–ø–æ—Å–∏–ª–∞–Ω–Ω—è|—Å–∏–º–≤–æ–ª –∑ º—î–¥–Ω–∞–Ω–Ω—è –ª–∞–Ω–æ–∫|—Å–∫—Ä—ñ–ø–ª–µ–Ω–Ω—è
üîò	–ø–µ—Ä–µ–º–∏–∫–∞—á	–≥–µ–æ–º–µ—Ç—Ä–∏—á–Ω–∏–π|–∫–Ω–æ–ø–∫–∞|–ø–µ—Ä–µ–º–∏–∫–∞—á
üîô	—Å—Ç—Ä—ñ–ª–∫–∞ –Ω–∞–∑–∞–¥ [BACK]	–Ω–∞–∑–∞–¥|—Å—Ç—Ä—ñ–ª–∫–∞|—Å—Ç—Ä—ñ–ª–∫–∞ BACK|—Å—Ç—Ä—ñ–ª–∫–∞ –Ω–∞–∑–∞–¥ [BACK]|—Å—Ç—Ä—ñ–ª–∫–∞ –Ω–∞–∑–∞–¥ BACK
üîö	—Å—Ç—Ä—ñ–ª–∫–∞ [END]	–∫—ñ–Ω–µ—Ü—å|—Å—Ç—Ä—ñ–ª–∫–∞|—Å—Ç—Ä—ñ–ª–∫–∞ [END]
üîõ	—Å—Ç—Ä—ñ–ª–∫–∞ [ON!]	–≤–≤—ñ–º–∫–Ω–µ–Ω–æ|–∑–Ω–∞—á–æ–∫|–æ–±–∏–¥–≤–∞ –Ω–∞–ø—Ä—è–º–∫–∏|—Å—Ç—Ä—ñ–ª–∫–∞|—Å—Ç—Ä—ñ–ª–∫–∞ [ON!]
üîú	—Å—Ç—Ä—ñ–ª–∫–∞ [SOON]	–Ω–µ–∑–∞–±–∞—Ä–æ–º|—Å—Ç—Ä—ñ–ª–∫–∞|—Å—Ç—Ä—ñ–ª–∫–∞ [SOON]
üîù	—Å—Ç—Ä—ñ–ª–∫–∞ [TOP]	–≤–≤–µ—Ä—Ö|–≤–≥–æ—Ä—É|—Å—Ç—Ä—ñ–ª–∫–∞|—Å—Ç—Ä—ñ–ª–∫–∞ [TOP]
üîû	–≤—Ö—ñ–¥ –æ—Å–æ–±–∞–º –¥–æ 18 —Ä–æ–∫—ñ–≤ –∑–∞–±–æ—Ä–æ–Ω–µ–Ω–∏–π	18|–≤—ñ–∫–æ–≤–µ –æ–±–º–µ–∂–µ–Ω–Ω—è|–≤—ñ—Å—ñ–º–Ω–∞–¥—Ü—è—Ç—å|–≤—ñ—Å—ñ–º–Ω–∞–¥—Ü—è—Ç—å —ñ —Å—Ç–∞—Ä—ñ—à–µ|–≤—Ö—ñ–¥ –æ—Å–æ–±–∞–º –¥–æ 18 —Ä–æ–∫—ñ–≤ –∑–∞–±–æ—Ä–æ–Ω–µ–Ω–∏–π|–∑–∞–±–æ—Ä–æ–Ω–µ–Ω–æ|–ª–∏—à–µ –¥–ª—è –ø–æ–≤–Ω–æ–ª—ñ—Ç–Ω—ñ—Ö|–ø–æ–≤–Ω–æ–ª—ñ—Ç–Ω—ñ–π
üî†	–≤–≤–µ–¥–µ–Ω–Ω—è –≤–µ–ª–∏–∫–∏–º–∏ –ª–∞—Ç–∏–Ω—Å—å–∫–∏–º–∏ –ª—ñ—Ç–µ—Ä–∞–º–∏	–≤–≤–µ–¥–µ–Ω–Ω—è|–≤–≤–µ–¥–µ–Ω–Ω—è –≤–µ–ª–∏–∫–∏–º–∏ –ª–∞—Ç–∏–Ω—Å—å–∫–∏–º–∏ –ª—ñ—Ç–µ—Ä–∞–º–∏|–≤–µ–ª–∏–∫—ñ|–ª–∞—Ç–∏–Ω—Å—å–∫—ñ|–ª—ñ—Ç–µ—Ä–∏
üî°	–≤–≤–µ–¥–µ–Ω–Ω—è –º–∞–ª–∏–º–∏ –ª–∞—Ç–∏–Ω—Å—å–∫–∏–º–∏ –ª—ñ—Ç–µ—Ä–∞–º–∏	abcd|–∞–ª—Ñ–∞–≤—ñ—Ç|–≤–≤–µ–¥–µ–Ω–Ω—è|–≤–≤–µ–¥–µ–Ω–Ω—è –º–∞–ª–∏–º–∏ –ª–∞—Ç–∏–Ω—Å—å–∫–∏–º–∏ –ª—ñ—Ç–µ—Ä–∞–º–∏|–ª–∞—Ç–∏–Ω—Å—å–∫—ñ|–ª—ñ—Ç–µ—Ä–∏|–º–∞–ª—ñ
üî¢	–≤–≤–µ–¥–µ–Ω–Ω—è —Ü–∏—Ñ—Ä–∞–º–∏	1234|–≤–≤–µ–¥–µ–Ω–Ω—è|–≤–≤–µ–¥–µ–Ω–Ω—è —Ü–∏—Ñ—Ä–∞–º–∏|—Ü–∏—Ñ—Ä–∏
üî£	–≤–≤–µ–¥–µ–Ω–Ω—è —Å–∏–º–≤–æ–ª—ñ–≤	&|%|‚ô™|„Äí|–≤–≤—ñ–¥|–Ω–∞–±—ñ—Ä|—Å–∏–º–≤–æ–ª–∏
üî§	–≤–≤–µ–¥–µ–Ω–Ω—è –ª–∞—Ç–∏–Ω—Å—å–∫–∏–º–∏ –ª—ñ—Ç–µ—Ä–∞–º–∏	abc|–∞–ª—Ñ–∞–≤—ñ—Ç|–≤–≤–µ–¥–µ–Ω–Ω—è|–≤–≤–µ–¥–µ–Ω–Ω—è –ª–∞—Ç–∏–Ω—Å—å–∫–∏–º–∏ –ª—ñ—Ç–µ—Ä–∞–º–∏|–ª–∞—Ç–∏–Ω–Ω–∏—Ü—è|–ª–∞—Ç–∏–Ω—Å—å–∫—ñ|–ª—ñ—Ç–µ—Ä–∏
üî•	–≤–æ–≥–æ–Ω—å	–≤–æ–≥–æ–Ω—å|—ñ–Ω—Å—Ç—Ä—É–º–µ–Ω—Ç|–ø–æ–ª—É–º‚Äô—è
üî¶	–ª—ñ—Ö—Ç–∞—Ä–∏–∫	–µ–ª–µ–∫—Ç—Ä–∏—á–Ω–∏–π|—ñ–Ω—Å—Ç—Ä—É–º–µ–Ω—Ç|–ª—ñ—Ö—Ç–∞—Ä–∏–∫|—Å–≤—ñ—Ç–ª–æ
üîß	–≥–∞–π–∫–æ–≤–∏–π –∫–ª—é—á	–≥–∞–π–∫–æ–≤–∏–π –∫–ª—é—á|—ñ–Ω—Å—Ç—Ä—É–º–µ–Ω—Ç|—Ä–µ–º–æ–Ω—Ç—É–≤–∞—Ç–∏
üî®	–º–æ–ª–æ—Ç–æ–∫	–∑–∞–±–∏–≤–∞—Ç–∏|—ñ–Ω—Å—Ç—Ä—É–º–µ–Ω—Ç|–º–æ–ª–æ—Ç–æ–∫|—Ä–µ–º–æ–Ω—Ç—É–≤–∞—Ç–∏
üî©	–≥–∞–π–∫–∞ —Ç–∞ –±–æ–ª—Ç	–±–æ–ª—Ç|–≥–∞–π–∫–∞|–≥–∞–π–∫–∞ —Ç–∞ –±–æ–ª—Ç|—ñ–Ω—Å—Ç—Ä—É–º–µ–Ω—Ç
üî™	–∫—É—Ö–æ–Ω–Ω–∏–π –Ω—ñ–∂	–≥–æ—Ç—É–≤–∞–Ω–Ω—è|–∑–±—Ä–æ—è|–∑–Ω–∞—Ä—è–¥–¥—è|–∫—É—Ö–Ω—è|–∫—É—Ö–æ–Ω–Ω–∏–π –Ω—ñ–∂|–Ω—ñ–∂|—Ä—ñ–∑–∞—Ç–∏
üî´	–≤–æ–¥—è–Ω–∏–π –ø—ñ—Å—Ç–æ–ª–µ—Ç	–≤–æ–¥—è–Ω–∏–π –ø—ñ—Å—Ç–æ–ª–µ—Ç|–∑–±—Ä–æ—è|–∑–Ω–∞—Ä—è–¥–¥—è|—ñ–≥—Ä–∞—à–∫–æ–≤–∞ –∑–±—Ä–æ—è|—ñ–≥—Ä–∞—à–∫–æ–≤–∏–π –ø—ñ—Å—Ç–æ–ª–µ—Ç|–ø—ñ—Å—Ç–æ–ª–µ—Ç|—Ä–µ–≤–æ–ª—å–≤–µ—Ä
üî¨	–º—ñ–∫—Ä–æ—Å–∫–æ–ø	—ñ–Ω—Å—Ç—Ä—É–º–µ–Ω—Ç|–º—ñ–∫—Ä–æ—Å–∫–æ–ø
üî≠	—Ç–µ–ª–µ—Å–∫–æ–ø	–∞—Å—Ç—Ä–æ–Ω–æ–º|–¥–∏–≤–∏—Ç–∏—Å—è –Ω–∞ –∑—ñ—Ä–∫–∏|—ñ–Ω—Å—Ç—Ä—É–º–µ–Ω—Ç|—Ç–µ–ª–µ—Å–∫–æ–ø
üîÆ	–∫—Ä–∏—à—Ç–∞–ª–µ–≤–∞ –∫—É–ª—è	–≤—ñ—â—É–≤–∞–Ω–Ω—è|–≤–æ—Ä–æ–∂–∏—Ç–∏|–∫–∞–∑–∫–∞|–∫—Ä–∏—à—Ç–∞–ª–µ–≤–∞ –∫—É–ª—è|–º–∞–π–±—É—Ç–Ω—î|–ø–µ—Ä–µ–¥–±–∞—á–∞—Ç–∏ –º–∞–π–±—É—Ç–Ω—î|–ø–µ—Ä–µ–¥–±–∞—á–µ–Ω–Ω—è|—Ñ–∞–Ω—Ç–∞–∑—ñ—è|—Ñ–æ—Ä—Ç—É–Ω–∞
üîØ	—à–µ—Å—Ç–∏–∫—É—Ç–Ω–∞ –∑—ñ—Ä–∫–∞ –∑ –∫—Ä–∞–ø–∫–æ—é	—î–≤—Ä–µ–π|–∑—ñ—Ä–∫–∞|—ñ—É–¥–∞—ó–∑–º|—Ä–µ–ª—ñ–≥—ñ—è|—É–¥–∞—á–∞|—à–µ—Å—Ç–∏–∫—É—Ç–Ω–∞ –∑—ñ—Ä–∫–∞|—à–µ—Å—Ç–∏–∫—É—Ç–Ω–∞ –∑—ñ—Ä–∫–∞ –∑ –∫—Ä–∞–ø–∫–æ—é
üî∞	—è–ø–æ–Ω—Å—å–∫–∏–π —Å–∏–º–≤–æ–ª ¬´–ø–æ—á–∞—Ç–∫—ñ–≤–µ—Ü—å¬ª	–∂–æ–≤—Ç–∏–π|–∑–µ–ª–µ–Ω–∏–π|–ª–∏—Å—Ç–æ–∫|–ø–æ—á–∞—Ç–∫—ñ–≤–µ—Ü—å|—à–µ–≤—Ä–æ–Ω|—è–ø–æ–Ω—Å—å–∫–∏–π|—è–ø–æ–Ω—Å—å–∫–∏–π —Å–∏–º–≤–æ–ª ¬´–ø–æ—á–∞—Ç–∫—ñ–≤–µ—Ü—å¬ª
üî±	—Ç—Ä–∏–∑—É–±	–µ–º–±–ª–µ–º–∞|—ñ–Ω—Å—Ç—Ä—É–º–µ–Ω—Ç|–∫–æ—Ä–∞–±–µ–ª—å|—Ç—Ä–∏–∑—É–±|—è–∫—ñ—Ä
üî≤	–∫–≤–∞–¥—Ä–∞—Ç–Ω–∞ –∫–Ω–æ–ø–∫–∞ –∑ —á–æ—Ä–Ω–æ—é —Ä–∞–º–∫–æ—é	–≥–µ–æ–º–µ—Ç—Ä–∏—á–Ω–∏–π|–≥–µ–æ–º–µ—Ç—Ä—ñ—è|–∫–≤–∞–¥—Ä–∞—Ç|–∫–≤–∞–¥—Ä–∞—Ç–Ω–∞ –∫–Ω–æ–ø–∫–∞ –∑ —á–æ—Ä–Ω–æ—é —Ä–∞–º–∫–æ—é|–∫–Ω–æ–ø–∫–∞|—Ä–∞–º–∫–∞|—á–æ—Ä–Ω–∞ –∫–≤–∞–¥—Ä–∞—Ç–Ω–∞ –∫–Ω–æ–ø–∫–∞
üî≥	–∫–≤–∞–¥—Ä–∞—Ç–Ω–∞ –∫–Ω–æ–ø–∫–∞ –∑ –±—ñ–ª–æ—é —Ä–∞–º–∫–æ—é	–±—ñ–ª–∞ –∫–≤–∞–¥—Ä–∞—Ç–Ω–∞ –∫–Ω–æ–ø–∫–∞|–≥–µ–æ–º–µ—Ç—Ä–∏—á–Ω–∏–π|–∫–≤–∞–¥—Ä–∞—Ç|–∫–≤–∞–¥—Ä–∞—Ç–Ω–∞ –∫–Ω–æ–ø–∫–∞ –∑ –±—ñ–ª–æ—é —Ä–∞–º–∫–æ—é|–∫–Ω–æ–ø–∫–∞|–∫–æ–Ω—Ç—É—Ä
üî¥	—á–µ—Ä–≤–æ–Ω–∏–π –∫—Ä—É–≥	–≥–µ–æ–º–µ—Ç—Ä–∏—á–Ω–∏–π|–∫–æ–ª–æ|—á–µ—Ä–≤–æ–Ω–µ|—á–µ—Ä–≤–æ–Ω–∏–π –∫—Ä—É–≥
üîµ	c–∏–Ω—ñ–π –∫—Ä—É–≥	c–∏–Ω—ñ–π –∫—Ä—É–≥|–≥–µ–æ–º–µ—Ç—Ä–∏—á–Ω–∏–π|–∫–æ–ª–æ|—Å–∏–Ω—î
üî∂	–≤–µ–ª–∏–∫–∏–π –æ—Ä–∞–Ω–∂–µ–≤–∏–π —Ä–æ–º–±	–≤–µ–ª–∏–∫–∏–π|–≤–µ–ª–∏–∫–∏–π –æ—Ä–∞–Ω–∂–µ–≤–∏–π —Ä–æ–º–±|–≤–µ–ª–∏–∫–∏–π –ø–æ–º–∞—Ä–∞–Ω—á–µ–≤–∏–π —Ä–æ–º–±|–≥–µ–æ–º–µ—Ç—Ä–∏—á–Ω–∏–π|–¥—ñ–∞–º–∞–Ω—Ç|–æ—Ä–∞–Ω–∂–µ–≤–∏–π|–æ—Ä–∞–Ω–∂–µ–≤–∏–π —Ä–æ–º–±
üî∑	–≤–µ–ª–∏–∫–∏–π —Å–∏–Ω—ñ–π —Ä–æ–º–±	–≤–µ–ª–∏–∫–∏–π —Å–∏–Ω—ñ–π —Ä–æ–º–±|–≥–µ–æ–º–µ—Ç—Ä–∏—á–Ω–∏–π|–¥—ñ–∞–º–∞–Ω—Ç|—Å–∏–Ω—ñ–π|—Å–∏–Ω—ñ–π —Ä–æ–º–±
üî∏	–º–∞–ª–∏–π –æ—Ä–∞–Ω–∂–µ–≤–∏–π —Ä–æ–º–±	–≥–µ–æ–º–µ—Ç—Ä–∏—á–Ω–∏–π|–¥—ñ–∞–º–∞–Ω—Ç|–º–∞–ª–∏–π|–º–∞–ª–∏–π –æ—Ä–∞–Ω–∂–µ–≤–∏–π —Ä–æ–º–±|–º–∞–ª–∏–π –ø–æ–º–∞—Ä–∞–Ω—á–µ–≤–∏–π —Ä–æ–º–±|–æ—Ä–∞–Ω–∂–µ–≤–∏–π|–ø–æ–º–∞—Ä–∞–Ω—á–µ–≤–∏–π|–ø–æ–º–∞—Ä–∞–Ω—á–µ–≤–∏–π —Ä–æ–º–±
üîπ	–º–∞–ª–∏–π —Å–∏–Ω—ñ–π —Ä–æ–º–±	–≥–µ–æ–º–µ—Ç—Ä–∏—á–Ω–∏–π|–¥—ñ–∞–º–∞–Ω—Ç|–º–∞–ª–∏–π —Å–∏–Ω—ñ–π —Ä–æ–º–±|—Å–∏–Ω—ñ–π|—Å–∏–Ω—ñ–π —Ä–æ–º–±
üî∫	—á–µ—Ä–≤–æ–Ω–∏–π —Ç—Ä–∏–∫—É—Ç–Ω–∏–∫, –Ω–∞–ø—Ä–∞–≤–ª–µ–Ω–∏–π —É–≥–æ—Ä—É	–≥–µ–æ–º–µ—Ç—Ä–∏—á–Ω–∏–π|–Ω–∞–ø—Ä–∞–≤–ª–µ–Ω–∏–π —É–≥–æ—Ä—É|—á–µ—Ä–≤–æ–Ω–∏–π|—á–µ—Ä–≤–æ–Ω–∏–π —Ç—Ä–∏–∫—É—Ç–Ω–∏–∫|—á–µ—Ä–≤–æ–Ω–∏–π —Ç—Ä–∏–∫—É—Ç–Ω–∏–∫, –Ω–∞–ø—Ä–∞–≤–ª–µ–Ω–∏–π —É–≥–æ—Ä—É
üîª	—á–µ—Ä–≤–æ–Ω–∏–π —Ç—Ä–∏–∫—É—Ç–Ω–∏–∫, –Ω–∞–ø—Ä–∞–≤–ª–µ–Ω–∏–π —É–Ω–∏–∑	–≤–Ω–∏–∑|–≥–µ–æ–º–µ—Ç—Ä–∏—á–Ω–∏–π|–Ω–∞–ø—Ä–∞–≤–ª–µ–Ω–∏–π —É–Ω–∏–∑|—á–µ—Ä–≤–æ–Ω–∏–π|—á–µ—Ä–≤–æ–Ω–∏–π —Ç—Ä–∏–∫—É—Ç–Ω–∏–∫|—á–µ—Ä–≤–æ–Ω–∏–π —Ç—Ä–∏–∫—É—Ç–Ω–∏–∫, –Ω–∞–ø—Ä–∞–≤–ª–µ–Ω–∏–π —É–Ω–∏–∑
üîº	–∫–Ω–æ–ø–∫–∞ –¥–æ–≥–æ—Ä–∏	–∫–Ω–æ–ø–∫–∞|–∫–Ω–æ–ø–∫–∞ ¬´–£–≥–æ—Ä—É¬ª|–∫–Ω–æ–ø–∫–∞ –¥–æ–≥–æ—Ä–∏|—Å—Ç—Ä—ñ–ª–∫–∞|—á–µ—Ä–≤–æ–Ω–∏–π
üîΩ	–∫–Ω–æ–ø–∫–∞ –¥–æ–Ω–∏–∑—É	–≤–Ω–∏–∑|–∫–Ω–æ–ø–∫–∞|–∫–Ω–æ–ø–∫–∞ ¬´–£–Ω–∏–∑¬ª|–∫–Ω–æ–ø–∫–∞ –¥–æ–Ω–∏–∑—É|—Å—Ç—Ä—ñ–ª–∫–∞|—á–µ—Ä–≤–æ–Ω–∏–π
üïã	–ö–∞–∞–±–∞	—ñ—Å–ª–∞–º|–∫–∞–∞–±–∞|–ö–∞–∞–±–∞|–º—É—Å—É–ª—å–º–∞–Ω—Å—å–∫–∏–π|—Ä–µ–ª—ñ–≥—ñ—è|—Ö–∞–¥–∂
üïå	–º–µ—á–µ—Ç—å	—ñ—Å–ª–∞–º|–º–µ—á–µ—Ç—å|–º—É—Å—É–ª—å–º–∞–Ω—Å—å–∫–∏–π|—Ä–µ–ª—ñ–≥—ñ—è
üïç	—Å–∏–Ω–∞–≥–æ–≥–∞	—î–≤—Ä–µ–π|—î–≤—Ä–µ–π—Å—å–∫–∏–π|—ñ—É–¥–∞—ó–∑–º|—Ä–µ–ª—ñ–≥—ñ—è|—Å–∏–Ω–∞–≥–æ–≥–∞|—Ö—Ä–∞–º
üïé	–º–µ–Ω–æ—Ä–∞	–∫–∞–Ω–¥–µ–ª—è–±—Ä|–º–µ–Ω–æ—Ä–∞|–ø—ñ–¥—Å–≤—ñ—á–Ω–∏–∫|—Ä–µ–ª—ñ–≥—ñ—è|–•–∞–Ω—É–∫–∞
üïê	–ø–µ—Ä—à–∞ –≥–æ–¥–∏–Ω–∞	00|1|1:00|–≥–æ–¥–∏–Ω–∞|–≥–æ–¥–∏–Ω–Ω–∏–∫|–æ–¥–∏–Ω|–ø–µ—Ä—à–∞ –≥–æ–¥–∏–Ω–∞
üïë	–¥—Ä—É–≥–∞ –≥–æ–¥–∏–Ω–∞	00|2|2:00|–≥–æ–¥–∏–Ω–∞|–≥–æ–¥–∏–Ω–Ω–∏–∫|–¥–≤–∞|–¥—Ä—É–≥–∞ –≥–æ–¥–∏–Ω–∞
üïí	—Ç—Ä–µ—Ç—è –≥–æ–¥–∏–Ω–∞	00|3|3:00|–≥–æ–¥–∏–Ω–∞|–≥–æ–¥–∏–Ω–Ω–∏–∫|—Ç—Ä–µ—Ç—è –≥–æ–¥–∏–Ω–∞|—Ç—Ä–∏
üïì	—á–µ—Ç–≤–µ—Ä—Ç–∞ –≥–æ–¥–∏–Ω–∞	00|4|4:00|–≥–æ–¥–∏–Ω–∞|–≥–æ–¥–∏–Ω–Ω–∏–∫|—á–µ—Ç–≤–µ—Ä—Ç–∞ –≥–æ–¥–∏–Ω–∞|—á–æ—Ç–∏—Ä–∏
üïî	–ø‚Äô—è—Ç–∞ –≥–æ–¥–∏–Ω–∞	00|5|5:00|–≥–æ–¥–∏–Ω–∞|–≥–æ–¥–∏–Ω–Ω–∏–∫|–ø‚Äô—è—Ç–∞ –≥–æ–¥–∏–Ω–∞|–ø‚Äô—è—Ç—å
üïï	—à–æ—Å—Ç–∞ –≥–æ–¥–∏–Ω–∞	00|6|6:00|–≥–æ–¥–∏–Ω–∞|–≥–æ–¥–∏–Ω–Ω–∏–∫|—à—ñ—Å—Ç—å|—à–æ—Å—Ç–∞ –≥–æ–¥–∏–Ω–∞
üïñ	—Å—å–æ–º–∞ –≥–æ–¥–∏–Ω–∞	00|7|7:00|–≥–æ–¥–∏–Ω–∞|–≥–æ–¥–∏–Ω–Ω–∏–∫|—Å—ñ–º|—Å—å–æ–º–∞ –≥–æ–¥–∏–Ω–∞
üïó	–≤–æ—Å—å–º–∞ –≥–æ–¥–∏–Ω–∞	00|8|8:00|–≤—ñ—Å—ñ–º|–≤–æ—Å—å–º–∞ –≥–æ–¥–∏–Ω–∞|–≥–æ–¥–∏–Ω–∞|–≥–æ–¥–∏–Ω–Ω–∏–∫
üïò	–¥–µ–≤‚Äô—è—Ç–∞ –≥–æ–¥–∏–Ω–∞	00|9|9:00|–≥–æ–¥–∏–Ω–∞|–≥–æ–¥–∏–Ω–Ω–∏–∫|–¥–µ–≤‚Äô—è—Ç–∞ –≥–æ–¥–∏–Ω–∞|–¥–µ–≤‚Äô—è—Ç—å
üïô	–¥–µ—Å—è—Ç–∞ –≥–æ–¥–∏–Ω–∞	00|10|10:00|–≥–æ–¥–∏–Ω–∞|–≥–æ–¥–∏–Ω–Ω–∏–∫|–¥–µ—Å—è—Ç–∞ –≥–æ–¥–∏–Ω–∞|–¥–µ—Å—è—Ç—å
üïö	–æ–¥–∏–Ω–∞–¥—Ü—è—Ç–∞ –≥–æ–¥–∏–Ω–∞	00|11|11:00|–≥–æ–¥–∏–Ω–∞|–≥–æ–¥–∏–Ω–Ω–∏–∫|–æ–¥–∏–Ω–∞–¥—Ü—è—Ç–∞ –≥–æ–¥–∏–Ω–∞|–æ–¥–∏–Ω–∞–¥—Ü—è—Ç—å
üïõ	–¥–≤–∞–Ω–∞–¥—Ü—è—Ç–∞ –≥–æ–¥–∏–Ω–∞	00|12|12:00|–≥–æ–¥–∏–Ω–∞|–≥–æ–¥–∏–Ω–Ω–∏–∫|–¥–≤–∞–Ω–∞–¥—Ü—è—Ç–∞ –≥–æ–¥–∏–Ω–∞|–¥–≤–∞–Ω–∞–¥—Ü—è—Ç—å|—á–∞—Å
üïú	–ø—ñ–≤ –Ω–∞ –¥—Ä—É–≥—É	1|1:30|30|–≥–æ–¥–∏–Ω–Ω–∏–∫|–æ–¥–∏–Ω|–ø—ñ–≤ –Ω–∞ –¥—Ä—É–≥—É|—Ç—Ä–∏–¥—Ü—è—Ç—å
üïù	–ø—ñ–≤ –Ω–∞ —Ç—Ä–µ—Ç—é	2|2:30|30|–≥–æ–¥–∏–Ω–Ω–∏–∫|–¥–≤–∞|–ø—ñ–≤ –Ω–∞ —Ç—Ä–µ—Ç—é|—Ç—Ä–∏–¥—Ü—è—Ç—å
üïû	–ø—ñ–≤ –Ω–∞ —á–µ—Ç–≤–µ—Ä—Ç—É	3|3:30|30|–≥–æ–¥–∏–Ω–Ω–∏–∫|–ø—ñ–≤ –Ω–∞ —á–µ—Ç–≤–µ—Ä—Ç—É|—Ç—Ä–∏|—Ç—Ä–∏–¥—Ü—è—Ç—å
üïü	–ø—ñ–≤ –Ω–∞ –ø‚Äô—è—Ç—É	30|4|4:30|–≥–æ–¥–∏–Ω–Ω–∏–∫|–ø—ñ–≤ –Ω–∞ –ø‚Äô—è—Ç—É|—Ç—Ä–∏–¥—Ü—è—Ç—å|—á–æ—Ç–∏—Ä–∏
üï†	–ø—ñ–≤ –Ω–∞ —à–æ—Å—Ç—É	30|5|5:30|–≥–æ–¥–∏–Ω–Ω–∏–∫|–ø‚Äô—è—Ç—å|–ø—ñ–≤ –Ω–∞ —à–æ—Å—Ç—É|—Ç—Ä–∏–¥—Ü—è—Ç—å
üï°	–ø—ñ–≤ –Ω–∞ —Å—å–æ–º—É	30|6|6:30|–≥–æ–¥–∏–Ω–Ω–∏–∫|–ø—ñ–≤ –Ω–∞ —Å—å–æ–º—É|—Ç—Ä–∏–¥—Ü—è—Ç—å|—à—ñ—Å—Ç—å
üï¢	–ø—ñ–≤ –Ω–∞ –≤–æ—Å—å–º—É	30|7|7:30|–≥–æ–¥–∏–Ω–Ω–∏–∫|–ø—ñ–≤ –Ω–∞ –≤–æ—Å—å–º—É|—Å—ñ–º|—Ç—Ä–∏–¥—Ü—è—Ç—å
üï£	–ø—ñ–≤ –Ω–∞ –¥–µ–≤‚Äô—è—Ç—É	30|8|8:30|–≤—ñ—Å—ñ–º|–≥–æ–¥–∏–Ω–Ω–∏–∫|–ø—ñ–≤ –Ω–∞ –¥–µ–≤‚Äô—è—Ç—É|—Ç—Ä–∏–¥—Ü—è—Ç—å
üï§	–ø—ñ–≤ –Ω–∞ –¥–µ—Å—è—Ç—É	30|9|9:30|–≥–æ–¥–∏–Ω–Ω–∏–∫|–¥–µ–≤‚Äô—è—Ç—å|–ø—ñ–≤ –Ω–∞ –¥–µ—Å—è—Ç—É|—Ç—Ä–∏–¥—Ü—è—Ç—å
üï•	–ø—ñ–≤ –Ω–∞ –æ–¥–∏–Ω–∞–¥—Ü—è—Ç—É	10|10:30|30|–≥–æ–¥–∏–Ω–Ω–∏–∫|–¥–µ—Å—è—Ç—å|–ø—ñ–≤ –Ω–∞ –æ–¥–∏–Ω–∞–¥—Ü—è—Ç—É|—Ç—Ä–∏–¥—Ü—è—Ç—å
üï¶	–ø—ñ–≤ –Ω–∞ –¥–≤–∞–Ω–∞–¥—Ü—è—Ç—É	11|11:30|30|–≥–æ–¥–∏–Ω–Ω–∏–∫|–æ–¥–∏–Ω–∞–¥—Ü—è—Ç—å|–ø—ñ–≤ –Ω–∞ –¥–≤–∞–Ω–∞–¥—Ü—è—Ç—É|—Ç—Ä–∏–¥—Ü—è—Ç—å
üïß	–ø—ñ–≤ –Ω–∞ –ø–µ—Ä—à—É	12|12:30|30|–≥–æ–¥–∏–Ω–Ω–∏–∫|–¥–≤–∞–Ω–∞–¥—Ü—è—Ç—å|–ø—ñ–≤ –Ω–∞ –ø–µ—Ä—à—É|—Ç—Ä–∏–¥—Ü—è—Ç—å
üï∫	—á–æ–ª–æ–≤—ñ–∫, —â–æ —Ç–∞–Ω—Ü—é—î	—Å–ø—ñ–≤–∞–∫|—Ç–∞–Ω—Ü—ñ|—á–æ–ª–æ–≤—ñ–∫|—á–æ–ª–æ–≤—ñ–∫ —Ç–∞–Ω—Ü—é—î|—á–æ–ª–æ–≤—ñ–∫, —â–æ —Ç–∞–Ω—Ü—é—î|—à–æ—É–º–µ–Ω|—â–æ —Ç–∞–Ω—Ü—é—î
üñï	—Å–µ—Ä–µ–¥–Ω—ñ–π –ø–∞–ª–µ—Ü—å	–ø–∞–ª–µ—Ü—å|—Ä—É–∫–∞|—Å–µ—Ä–µ–¥–Ω—ñ–π –ø–∞–ª–µ—Ü—å
üññ	–≤—É–ª–∫–∞–Ω—Å—å–∫–µ –≤—ñ—Ç–∞–Ω–Ω—è	–≤—É–ª–∫–∞–Ω|–≤—É–ª–∫–∞–Ω—Å—å–∫–µ –≤—ñ—Ç–∞–Ω–Ω—è|–∂–µ—Å—Ç|–∑–æ—Ä—è–Ω–∏–π —à–ª—è—Ö|–ø–∞–ª–µ—Ü—å|–ø–∞–ª—å—Ü—ñ|—Ä—É–∫–∞|—Å–ø–æ–∫|—Ç—ñ–ª–æ
üñ§	—á–æ—Ä–Ω–µ —Å–µ—Ä—Ü–µ	–∑–∞–∑–¥—Ä—ñ—Å—Ç—å|–∑–ª–æ|—Å–µ—Ä—Ü–µ|—á–æ—Ä–Ω–µ
üóª	–≥–æ—Ä–∞ –§—É–¥–∑—ñ	–≥–æ—Ä–∞|–§—É–¥–∑–∏|—Ñ—É–¥–∑—ñ
üóº	–¢–æ–∫—ñ–π—Å—å–∫–∞ –≤–µ–∂–∞	–≤–µ–∂–∞|—Ç–æ–∫—ñ–π—Å—å–∫–∞ –≤–µ–∂–∞|–¢–æ–∫—ñ–π—Å—å–∫–∞ –≤–µ–∂–∞|–¢–æ–∫—ñ–æ
üóΩ	–°—Ç–∞—Ç—É—è –°–≤–æ–±–æ–¥–∏	—Å–≤–æ–±–æ–¥–∞|—Å—Ç–∞—Ç—É—è|—Å—Ç–∞—Ç—É—è —Å–≤–æ–±–æ–¥–∏|–°—Ç–∞—Ç—É—è –°–≤–æ–±–æ–¥–∏|–°–®–ê
üóæ	–∫–∞—Ä—Ç–∞ –Ø–ø–æ–Ω—ñ—ó	–∫–∞—Ä—Ç–∞|–∫–∞—Ä—Ç–∞ —è–ø–æ–Ω—ñ—ó|–∫–∞—Ä—Ç–∞ –Ø–ø–æ–Ω—ñ—ó|–º–∞–ø–∞ –Ø–ø–æ–Ω—ñ—ó|–æ—Å—Ç—Ä—ñ–≤|—è–ø–æ–Ω—ñ—è|–Ø–ø–æ–Ω—ñ—è
üóø	—Å—Ç–∞—Ç—É—è –∑ –û—Å—Ç—Ä–æ–≤–∞ –ü–∞—Å—Ö–∏	–ª–∏—Ü–µ|–º–æ–∞–π|—Å—Ç–∞—Ç—É—è|—Å—Ç–∞—Ç—É—è –∑ –û—Å—Ç—Ä–æ–≤–∞ –ü–∞—Å—Ö–∏
üòÄ	—à–∏—Ä–æ–∫–æ –≤—Å–º—ñ—Ö–Ω–µ–Ω–µ –æ–±–ª–∏—á—á—è	–≤–∏—â–∏—Ä|–æ–±–ª–∏—á—á—è|–ø–æ—Å–º—ñ—à–∫–∞|—Ä–∞–¥—ñ—Å—Ç—å|—Å–º—ñ—Ö|—É—Å–º—ñ—Ö–Ω–µ–Ω–∏–π|—É—Å–º—ñ—à–∫–∞|—à–∏—Ä–æ–∫–∏–π
üòÅ	–æ—Å—è–π–Ω–æ –≤—Å–º—ñ—Ö–Ω–µ–Ω–µ –æ–±–ª–∏—á—á—è –π –æ—á—ñ	–∑—É–±–∏|–æ–±–ª–∏—á—á—è|–æ—Å—è–π–Ω–æ|–æ—á—ñ|–ø–æ—Å–º—ñ—à–∫–∞|—Ä–∞–¥—ñ—Å–Ω–∏–π|—Å–≤—ñ—Ç–∏—Ç—å—Å—è|—É—Å–º—ñ—à–∫–∞|—à–∏—Ä–æ–∫–æ|—à–∫—ñ—Ä–∏—Ç—å—Å—è|—â–∞—Å–ª–∏–≤–∏–π
üòÇ	–æ–±–ª–∏—á—á—è –≤ —Å–ª—å–æ–∑–∞—Ö —Ä–∞–¥–æ—Å—Ç—ñ	–≤–µ—Å–µ–ª–∏–π|–¥–æ —Å–ª—ñ–∑|–∫—É–º–µ–¥–Ω–∏–π|–ª–æ–ª|–æ–±–ª–∏—á—á—è|—Ä–∞–¥—ñ—Å—Ç—å|—Ä–µ–≥—ñ—Ç|—Ä–æ–∑—Å–º—ñ—à–∏—Ç–∏|—Å–ª—å–æ–∑–∏|—Å–º—ñ—Ö|—Ö–∞—Ö–∞
üòÉ	—à–∏—Ä–æ–∫–æ –≤—Å–º—ñ—Ö–Ω–µ–Ω–µ –æ–±–ª–∏—á—á—è –∑ –æ—á–∏—â–∞–º–∏	–≤–µ–ª–∏–∫–∏–π|–≤–∏—â–∏—Ä|–≤—ñ–¥–∫—Ä–∏—Ç–∏–π|–æ–±–ª–∏—á—á—è|–æ—á–∏—â–∞|–æ—á—ñ|–ø–æ—Å–º—ñ—à–∫–∞|—Ä–∞–¥—ñ—Å—Ç—å|—Ä–æ—Ç|—Å–º—ñ—Ö|—É—Å–º—ñ—Ö–Ω–µ–Ω–∏–π|—É—Å–º—ñ—à–∫–∞|—à–∏—Ä–æ–∫–∏–π
üòÑ	—à–∏—Ä–æ–∫–æ –≤—Å–º—ñ—Ö–Ω–µ–Ω–µ –æ–±–ª–∏—á—á—è –∑ –ø—Ä–∏–º—Ä—É–∂–µ–Ω–∏–º–∏ –æ—á–∏–º–∞	–≤–µ–ª–∏–∫–∏–π|–≤–∏—â–∏—Ä|–≤—ñ–¥–∫—Ä–∏—Ç–∏–π|–æ–±–ª–∏—á—á—è|–æ—á–∏—â–∞|–æ—á—ñ|–ø–æ—Å–º—ñ—à–∫–∞|–ø—Ä–∏–º—Ä—É–∂–µ–Ω–∏–π|—Ä–∞–¥—ñ—Å—Ç—å|—Ä–æ—Ç|—Å–º—ñ—Ö|—É—Å–º—ñ—Ö–Ω–µ–Ω–∏–π|—É—Å–º—ñ—à–∫–∞|—à–∏—Ä–æ–∫–∏–π
üòÖ	—à–∏—Ä–æ–∫–æ –≤—Å–º—ñ—Ö–Ω–µ–Ω–µ –æ–±–ª–∏—á—á—è –∑ –ø–æ—Ç–æ–º	–≤—ñ–¥–∫—Ä–∏—Ç–∏–π|–∑–∞–¥–æ–≤–æ–ª–µ–Ω–∏–π|–æ–±–ª–∏—á—á—è|–ø—ñ—Ç|–ø–æ—Å–º—ñ—à–∫–∞|—Ä–∞–¥—ñ—Å—Ç—å|—Ä–µ–≥–æ—Ç–∞—Ç–∏|—Ä–æ—Ç|—Å–º—ñ—Ö|—Å–º—ñ—à–Ω–æ|—É—Å–º—ñ—Ö–Ω–µ–Ω–∏–π|—É—Å–º—ñ—à–∫–∞|—Ö–∞—Ö–∞|—Ö–æ–ª–æ–¥–Ω–∏–π|—à–∏—Ä–æ–∫–∏–π|—â–∞—Å–ª–∏–≤–∏–π
üòÜ	–æ–±–ª–∏—á—á—è —ñ–∑ —à–∏—Ä–æ–∫–æ—é –ø–æ—Å–º—ñ—à–∫–æ—é –π –∑–∞–º—Ä—É–∂–µ–Ω–∏–º–∏ –æ—á–∏–º–∞	–≤–µ–ª–∏–∫–∏–π|–≤—ñ–¥–∫—Ä–∏—Ç–∏–π|–∑–∞–¥–æ–≤–æ–ª–µ–Ω–∏–π|–æ–±–ª–∏—á—á—è|–æ—á—ñ|–ø–æ—Å–º—ñ—à–∫–∞|–ø—Ä–∏–º—Ä—É–∂–µ–Ω–∏–π|—Ä–∞–¥—ñ—Å—Ç—å|—Ä–µ–≥–æ—Ç–∞—Ç–∏|—Ä–æ—Ç|—Å–º—ñ—Ö|—Å–º—ñ—à–Ω–æ|—É—Å–º—ñ—Ö–Ω–µ–Ω–∏–π|—É—Å–º—ñ—à–∫–∞|—Ö–∞—Ö–∞|—à–∏—Ä–æ–∫–∏–π|—â–∞—Å–ª–∏–≤–∏–π
üòá	—É—Å–º—ñ—Ö–Ω–µ–Ω–µ –æ–±–ª–∏—á—á—è –∑ –Ω—ñ–º–±–æ–º	–∞–Ω–≥–µ–ª|–±–µ–∑–Ω–µ–≤–∏–Ω–Ω—ñ—Å—Ç—å|–∫–∞–∑–∫–∞|–Ω—ñ–º–±|–æ–±–ª–∏—á—á—è|–ø–æ—Å–º—ñ—à–∫–∞|—É—Å–º—ñ—à–∫–∞|—Ñ–∞–Ω—Ç–∞–∑—ñ—è|—è–Ω–≥–æ–ª
üòà	—É—Å–º—ñ—Ö–Ω–µ–Ω–µ –æ–±–ª–∏—á—á—è –∑ —Ä–æ–≥–∞–º–∏	–¥–µ–º–æ–Ω|–¥–∏—è–≤–æ–ª|–¥–∏—è–≤–æ–ª—å—Å—å–∫–∞ –ø–æ—Å–º—ñ—à–∫–∞|–∑ —Ä–æ–≥–∞–º–∏|–∑–ª–∞ –ø–æ—Å–º—ñ—à–∫–∞|–∫–∞–∑–∫–∞|–º–æ–Ω—Å—Ç—Ä|–æ–±–ª–∏—á—á—è|–ø–æ—Å–º—ñ—à–∫–∞|—Ä—ñ–∂–∫–∏|—Ñ–∞–Ω—Ç–∞–∑—ñ—è|—Ñ—ñ–æ–ª–µ—Ç–æ–≤–∏–π
üòâ	–æ–±–ª–∏—á—á—è, —â–æ –ø—ñ–¥–º–æ—Ä–≥—É—î	–¥—Ä–∞–∂–Ω–∏—Ç–∏|–∂–∞—Ä—Ç|–∑–∞–ª–∏—Ü—è—Ç–∏—Å—è|–æ–±–ª–∏—á—á—è|–ø—ñ–¥–º–æ—Ä–≥—É–≤–∞—Ç–∏|—Ñ–ª—ñ—Ä—Ç
üòä	—É—Å–º—ñ—Ö–Ω–µ–Ω–µ –æ–±–ª–∏—á—á—è –π –æ—á—ñ	–∑–∞–¥–æ–≤–æ–ª–µ–Ω–Ω—è|–Ω—ñ—è–∫–æ–≤–æ|–æ–±–ª–∏—á—á—è|–æ—á—ñ|–ø–æ—Å–º—ñ—à–∫–∞|—Ä—É–º‚Äô—è–Ω–µ—Ü—å|—Å–æ—Ä–æ–º–ª–∏–≤–∏–π|—É—Å–º—ñ—à–∫–∞
üòã	—É—Å–º—ñ—Ö–Ω–µ–Ω–µ –æ–±–ª–∏—á—á—è, —â–æ –æ–±–ª–∏–∑—É—î –≥—É–±–∏	–≥–æ–ª–æ–¥|—ó–∂–∞|–º–º–º|–æ–±–ª–∏—á—á—è|–ø–æ—Å–º—ñ—à–∫–∞|—Å–º–∞–∫|—Å–º–∞—á–Ω–æ|—Å—Ç—Ä–∞–≤–∞|—É—Å–º—ñ—à–∫–∞
üòå	–∑–∞—Å–ø–æ–∫–æ—î–Ω–µ –æ–±–ª–∏—á—á—è	–¥–∑–µ–Ω|–∑–∞–¥–æ–≤–æ–ª–µ–Ω–Ω—è|–æ–±–ª–∏—á—á—è|–ø–æ–ª–µ–≥—à–µ–Ω–Ω—è|—Å–ø–æ–∫—ñ–π
üòç	—É—Å–º—ñ—Ö–Ω–µ–Ω–µ –æ–±–ª–∏—á—á—è –∑ –æ—á–∏–º–∞-—Å–µ—Ä—Ü—è–º–∏	–∑ –∑–∞–¥–æ–≤–æ–ª–µ–Ω–Ω—è–º|–∑ —Ä–∞–¥—ñ—Å—Ç—é|–∑–∞–∫–æ—Ö–∞–Ω–∏–π|–∑–≤–æ—Ä—É—à–µ–Ω–∏–π|–∫–æ—Ö–∞–Ω–Ω—è|–ª—é–±–æ–≤|–æ–±–ª–∏—á—á—è|–æ—á—ñ|–ø–æ—Å–º—ñ—à–∫–∞|—Å–µ—Ä—Ü–µ|—Ö–æ—á—É
üòé	—É—Å–º—ñ—Ö–Ω–µ–Ω–µ –æ–±–ª–∏—á—á—è –≤ —Ç–µ–º–Ω–∏—Ö –æ–∫—É–ª—è—Ä–∞—Ö	–±—Ä–æ|–∫—Ä—É—Ç–∏–π|–∫—Ä—É—Ç–æ|–æ–∫—É–ª—è—Ä–∏|–ø–æ—Å–º—ñ—à–∫–∞|—Å–æ–Ω—Ü–µ|—Å–æ–Ω—Ü–µ–∑–∞—Ö–∏—Å–Ω—ñ|—Ç–µ–º–Ω—ñ|—É—Å–º—ñ—à–∫–∞|—á—É–≤–∞–∫|—è—Å–∫—Ä–∞–≤–æ
üòè	—Å–∞–º–æ–≤–¥–æ–≤–æ–ª–µ–Ω–µ –æ–±–ª–∏—á—á—è	–±–æ—Å|–ª—é–±–ª—é|–Ω–µ –¥—É–∂–µ|–æ–±–ª–∏—á—á—è|–ø–æ—Å–º—ñ—à–∫–∞|—Å–∞–º–æ–≤–¥–æ–≤–æ–ª–µ–Ω–Ω—è|—Å–µ–±–µ|—Å—É–º–Ω—ñ–≤–∞—é—Å—å|—Ç–∞–∫ —Å–æ–±—ñ|—É—Å–º—ñ—à–∫–∞|—É—Ö-—Ç–∏|—É—Ö—Ç–∏|—Ü—ñ–∫–∞–≤–æ
üòê	–æ–±–ª–∏—á—á—è –∑ –Ω–µ–π—Ç—Ä–∞–ª—å–Ω–∏–º –≤–∏—Ä–∞–∑–æ–º	–±–µ–∑ –µ–º–æ—Ü—ñ–π|–≤—Å–µ –æ–¥–Ω–æ|–∑–∞–∑–¥—Ä—ñ—Å—Ç—å|–Ω–µ –∑–≥–æ–¥–µ–Ω|–Ω–µ —Å–∫–∞–∂—É|–Ω–µ–≤—Ä–∞–∂–µ–Ω–∏–π|–Ω–µ–∑–∞–¥–æ–≤–æ–ª–µ–Ω–Ω—è|–Ω–µ–∑–≤–æ—Ä—É—à–Ω–∏–π|–Ω–µ–π—Ç—Ä–∞–ª—å–Ω–∏–π|–Ω–µ—Ö–∞–π|–Ω—ñ|–æ–±–ª–∏—á—á—è
üòë	–æ–±–ª–∏—á—á—è –±–µ–∑ –µ–º–æ—Ü—ñ–π	–±–µ–∑ –µ–º–æ—Ü—ñ–π|–≤—Å–µ –æ–¥–Ω–æ|–∑–∞–∑–¥—Ä—ñ—Å–Ω–∏–π|–Ω–µ–≤–∏—Ä–∞–∑–Ω–∏–π|–Ω–µ–≤—Ä–∞–∂–µ–Ω–∏–π|–Ω–µ—Ö–∞–π|–Ω—É –π –¥–æ–±—Ä–µ|–æ–±–ª–∏—á—á—è
üòí	–Ω–µ–≤–¥–æ–≤–æ–ª–µ–Ω–µ –æ–±–ª–∏—á—á—è	–≤—Å–µ –æ–¥–Ω–æ|–∑–∞–∑–¥—Ä—ñ—Å—Ç—å|–Ω–µ–≤–¥–æ–≤–æ–ª–µ–Ω–µ|–Ω–µ–∑–∞–¥–æ–≤–æ–ª–µ–Ω–∏–π|–Ω–µ—â–∞—Å–ª–∏–≤–∏–π|–Ω—É–¥–Ω–æ|–æ–±–ª–∏—á—á—è|—Ä–æ–∑—á–∞—Ä–æ–≤–∞–Ω–∏–π|—Ñ—É
üòì	–ø–æ–Ω—É—Ä–µ–Ω–µ –æ–±–ª–∏—á—á—è –≤ –ø–æ—Ç—É	–±–æ–ª–∏—Ç—å|–≥–æ–ª–æ–≤–∞|–∑–Ω–µ—Ä–≤–æ–≤–∞–Ω–∏–π|–∫—Ä–∞–ø–ª—ñ|–Ω–∞–ª—è–∫–∞–Ω–∏–π|–Ω–µ—Ä–≤–∏|–æ–±–ª–∏—á—á—è|–ø—ñ—Ç|–ø–æ–Ω—É—Ä–µ–Ω–∏–π|—Ä–æ–∑—á–∞—Ä–æ–≤–∞–Ω–∏–π|—Å—É–º|—Ö–æ–ª–æ–¥–Ω–∏–π
üòî	–∑–∞–º–∏—Å–ª–µ–Ω–µ –æ–±–ª–∏—á—á—è	–∑–∞–¥—É–º–ª–∏–≤–∏–π|–∑–∞–º–∏—Å–ª–µ–Ω–µ –æ–±–ª–∏—á—á—è|–∑–∞–Ω–µ–ø–æ–∫–æ—î–Ω–Ω—è|–∑–∞—Å–º—É—á–µ–Ω–∏–π|–æ–±–ª–∏—á—á—è|—Ä–æ–∑–¥—É–º–∏|—Ä–æ–∑—á–∞—Ä–æ–≤–∞–Ω–∏–π
üòï	—Å–ø–∞–Ω—Ç–µ–ª–∏—á–µ–Ω–µ –æ–±–ª–∏—á—á—è	–∞—è–∫–∂–µ|–≥–º|–Ω–µ –∑–∞–¥–æ–≤–æ–ª–µ–Ω–∏–π|–Ω–µ –∑–Ω–∞—é|–Ω–µ–≤–¥–æ–≤–æ–ª–µ–Ω–∏–π|–Ω—ñ|–æ–±–ª–∏—á—á—è|—Å–ø–∞–Ω—Ç–µ–ª–∏—á–µ–Ω–∏–π|—Å—É–º–Ω–∏–π
üòñ	–∑–±–µ–Ω—Ç–µ–∂–µ–Ω–µ –æ–±–ª–∏—á—á—è	–≥–Ω—ñ–≤|–∑–±–µ–Ω—Ç–µ–∂–µ–Ω–∏–π|–∑–ª–∏–π|–∫—Ä—ñ–Ω–∂|–æ–±–ª–∏—á—á—è|—Ä–æ–∑–ª—é—á–µ–Ω–∏–π|—Ä–æ–∑—á–∞—Ä–æ–≤–∞–Ω–∏–π|—Å–µ—Ä–¥–∏—Ç–∏–π|—Å—É–º–Ω–∏–π
üòó	–æ–±–ª–∏—á—á—è, —â–æ —Ü—ñ–ª—É—î	–∫–æ—Ö–∞–Ω–Ω—è|–æ–±–ª–∏—á—á—è|–ø–æ–±–∞—á–µ–Ω–Ω—è|–ø–æ—Ü—ñ–ª—É–Ω–æ–∫|—Ñ–ª—ñ—Ä—Ç|—Ü—ñ–ª—É–≤–∞—Ç–∏|—Ü—ñ–ª—É—î|—Ü—å–æ–º
üòò	–æ–±–ª–∏—á—á—è, —â–æ –Ω–∞–¥—Å–∏–ª–∞—î —Ü—ñ–ª—É–Ω–æ–∫	–æ–±–ª–∏—á—á—è|–ø–æ–≤—ñ—Ç—Ä—è–Ω–∏–π|–ø–æ—Ü—ñ–ª—É–Ω–æ–∫|—Å–µ—Ä—Ü–µ|—Ü—ñ–ª—É–Ω–æ–∫|—Ü—ñ–ª—É—é|—Ü—å–æ–º
üòô	–æ–±–ª–∏—á—á—è –∑ –ø—Ä–∏–º—Ä—É–∂–µ–Ω–∏–º–∏ –æ—á–∏–º–∞, —â–æ —Ü—ñ–ª—É—î	143|–∑–∞–ø–ª—é—â–µ–Ω–∏–π|–∑–Ω–∞–π–æ–º—Å—Ç–≤–∞|–∫–æ—Ö–∞–Ω–Ω—è|–Ω—ñ—á|–æ–±–ª–∏—á—á—è|–æ–∫–æ|–æ—á—ñ|–ø–æ–±–∞—á–µ–Ω–Ω—è|–ø–æ—Ü—ñ–ª—É–Ω–∫–∏|–ø–æ—Ü—ñ–ª—É–Ω–æ–∫|—É—Å–º—ñ—Ö–∞—Ç–∏—Å—è|—É—Å–º—ñ—à–∫–∞|—Ñ–ª—ñ—Ä—Ç|—Ü—ñ–ª—É–≤–∞—Ç–∏—Å—è
üòö	–æ–±–ª–∏—á—á—è —ñ–∑ –∑–∞–ø–ª—é—â–µ–Ω–∏–º–∏ –æ—á–∏–º–∞, —â–æ —Ü—ñ–ª—É—î	–∑–∞–∫—Ä–∏—Ç—ñ|–∑–∞–ø–ª—é—â–µ–Ω—ñ|–æ–±–ª–∏—á—á—è|–æ–∫–æ|–æ—á—ñ|–ø–æ–±–∞—á–µ–Ω–Ω—è|–ø–æ—Ü—ñ–ª—É–Ω–æ–∫|—Ñ–ª—ñ—Ä—Ç|—Ü—ñ–ª—É—î
üòõ	–æ–±–ª–∏—á—á—è –∑ –≤–∏—Å—É–Ω—É—Ç–∏–º —è–∑–∏–∫–æ–º	–≤–∏—Å–æ–ª–æ–ø–∏—Ç–∏|–≤–∏—Å—É–Ω—É—Ç–∏–π|–¥–æ–±—Ä–µ|–æ–±–ª–∏—á—á—è|–ø–æ–∫–∞–∑–∞—Ç–∏|—Ä–∞–¥—ñ—Å—Ç—å|—è–∑–∏–∫
üòú	–æ–±–ª–∏—á—á—è, —â–æ –ø—ñ–¥–º–æ—Ä–≥—É—î —ñ –ø–æ–∫–∞–∑—É—î —è–∑–∏–∫–∞	–∂–∞—Ä—Ç|–ª–æ–ª|–æ–±–ª–∏—á—á—è|–æ—á—ñ|–ø—ñ–¥–º–æ—Ä–≥—É–≤–∞—Ç–∏|–ø—ñ–¥–º–æ—Ä–≥—É—é|–ø–æ–∫–∞–∑–∞—Ç–∏|–ø–æ—Å–º—ñ—à–∫–∞|—É—Å–º—ñ—à–∫–∞|—Ö–∞—Ö–∞|—è–∑–∏–∫
üòù	–æ–±–ª–∏—á—á—è –∑ –≤–∏—Å—É–Ω—É—Ç–∏–º —è–∑–∏–∫–æ–º —ñ –∑–∞–ø–ª—é—â–µ–Ω–∏–º–∏ –æ—á–∏–º–∞	–≤–∏—Å—É–Ω—É—Ç–∏–π|–≥–∏–¥–æ—Ç–∞|–∂–∞—Ö–ª–∏–≤–∏–π|–∑–∞–ø–ª—é—â–µ–Ω—ñ|–æ–±–ª–∏—á—á—è|–æ—á—ñ|—Å–º–∞–∫|—Å–º—ñ—Ö|—Ç—å—Ñ—É|—Ñ—É|—è–∑–∏–∫
üòû	—Ä–æ–∑—á–∞—Ä–æ–≤–∞–Ω–µ –æ–±–ª–∏—á—á—è	–≤–∏–Ω—É–≤–∞—Ç–∏–π|–∑–∞—Å–º—É—á–µ–Ω–∏–π|–Ω–µ–≤–¥–∞—á–∞|–Ω–µ—â–∞—Å–Ω–∏–π|–æ–±–ª–∏—á—á—è|–ø—Ä–æ–≤–∏–Ω–∞|–ø—Ä–æ–≥—Ä–∞—à|—Ä–æ–∑—á–∞—Ä–æ–≤–∞–Ω–∏–π|—Å—É–º–Ω–∏–π
üòü	—Å—Ç—É—Ä–±–æ–≤–∞–Ω–µ –æ–±–ª–∏—á—á—è	–∑–∞–Ω–µ–ø–æ–∫–æ—î–Ω–Ω—è|–∑–¥–∏–≤–æ–≤–∞–Ω–∏–π|–Ω–µ—Ä–≤–∏|–æ–±–ª–∏—á—á—è|—Å—Ç—Ä–µ—Å|—Å—Ç—É—Ä–±–æ–≤–∞–Ω–∏–π|—Å—É–º–Ω–∏–π|—Ç—Ä–∏–≤–æ–∂–Ω—ñ—Å—Ç—å|—Ç—É—Ä–±—É–≤–∞—Ç–∏—Å—è
üò†	—Å–µ—Ä–¥–∏—Ç–µ –æ–±–ª–∏—á—á—è	–∑–ª–∏–π|–æ–±–ª–∏—á—á—è|—Å–µ—Ä–¥–∏—Ç–µ –æ–±–ª–∏—á—á—è|—Å–µ—Ä–¥–∏—Ç–∏–π
üò°	–æ–±–ª–∏—á—á—è, —â–æ –¥—É—î—Ç—å—Å—è	–≥–Ω—ñ–≤|–¥—É—î—Ç—å—Å—è|–∑–ª–∏–π|–Ω–∞—Å—É–ø–ª–µ–Ω–∏–π|–Ω–µ–≤–¥–æ–≤–æ–ª–µ–Ω–∏–π|–Ω–µ—â–∞—Å–Ω–∏–π|–æ–±–ª–∏—á—á—è|—Å–µ—Ä–¥–∏—Ç–∏–π|—á–µ—Ä–≤–æ–Ω–∏–π
üò¢	–æ–±–ª–∏—á—á—è, —â–æ –ø–ª–∞—á–µ	–Ω–µ—â–∞—Å–Ω–∏–π|–æ–±–ª–∏—á—á—è|–ø–ª–∞—á|–ø–ª–∞—á–µ|—Å–ª—å–æ–∑–∞|—Å—É–º–Ω–∏–π|—Å—É–º—É—é
üò£	–Ω–µ–≤—ñ–¥—Å—Ç—É–ø–Ω–µ –æ–±–ª–∏—á—á—è	–∑–∞–≤–∑—è—Ç–µ|–∑–æ—Å–µ—Ä–µ–¥–∂–µ–Ω–Ω—è|–∫–æ–Ω—Ü–µ–Ω—Ç—Ä–∞—Ü—ñ—è|–Ω–µ–≤–¥–æ–≤–æ–ª–µ–Ω–∏–π|–Ω–µ–≤—ñ–¥—Å—Ç—É–ø–Ω–µ|–æ–±–ª–∏—á—á—è|—Ä–æ–∑—á–∞—Ä–æ–≤–∞–Ω–∏–π|—É–≤–∞–≥–∞|—É–ø–µ—Ä—Ç—ñ—Å—Ç—å
üò§	–æ–±–ª–∏—á—á—è, —â–æ —Å–µ—Ä–¥–∏—Ç–æ –≤–∏–¥–∏—Ö–∞—î	–≥–Ω—ñ–≤|–∑–ª—ñ—Å—Ç—å|–ª—é—Ç—å|–æ–±–ª–∏—á—á—è|–ø–∞—Ä–∞ –∑ –Ω–æ—Å–∞|—Ä–æ–∑–≥–Ω—ñ–≤–∞–Ω–∏–π|—Ä–æ–∑–¥—Ä–∞—Ç–æ–≤–∞–Ω–∏–π|—Ä–æ–∑–ª—é—á–µ–Ω–∏–π|—Å–µ—Ä–¥–∏—Ç–∏–π|—Ç—Ä—ñ—É–º—Ñ|—à–∞–ª–µ–Ω–∏–π
üò•	c—É–º–Ω–µ, –∞–ª–µ –≤—Ç—ñ—à–µ–Ω–µ –æ–±–ª–∏—á—á—è	c—É–º–Ω–µ|–≤—Å–µ —Å–∫–ª–∞–¥–Ω–æ|–≤—Ç—ñ—à–µ–Ω–µ|–∑–∞—Å–ø–æ–∫–æ—î–Ω–µ|–æ–±–ª–∏—á—á—è|–ø–ª–∞–∫–∞—Ç–∏|–ø–æ–ª–µ–≥—à–µ–Ω–Ω—è|—Ä–æ–∑—á–∞—Ä–æ–≤–∞–Ω–µ|—Ä–æ–∑—á–∞—Ä—É–≤–∞–Ω–Ω—è|—Å–ª—å–æ–∑–∏|—Ñ—É—Ö
üò¶	–ø–æ—Ö–º—É—Ä–µ –æ–±–ª–∏—á—á—è –∑ –≤—ñ–¥–∫—Ä–∏—Ç–∏–º —Ä–æ—Ç–æ–º	–≤–∞—É|–≤—ñ–¥–∫—Ä–∏—Ç–∏–π|–∑–¥–∏–≤–æ–≤–∞–Ω–∏–π|–∑–Ω–µ–Ω–∞—Ü—å–∫–∞|–Ω–∞–ª—è–∫–∞–Ω–∏–π|–Ω–∞—Ö–º—É—Ä–µ–Ω–∏–π|–Ω—ñ—á–æ–≥–æ —Å–æ–±—ñ|–æ–±–ª–∏—á—á—è|—Ä–æ—Ç|—Å—Ç—Ä–∞—Ö
üòß	—Å—Ç—Ä–∞–∂–¥–µ–Ω–Ω–µ –æ–±–ª–∏—á—á—è	–∑–∞–±—É–≤|–∑–¥–∏–≤–æ–≤–∞–Ω–∏–π|–Ω–µ –º–æ–∂–µ –±—É—Ç–∏|–Ω–µ–∑–∞–¥–æ–≤–æ–ª–µ–Ω–∏–π|–æ–±–ª–∏—á—á—è|–ø–µ—Ä–µ–ª—è–∫|—Å–ø–∞–Ω—Ç–µ–ª–∏—á–µ–Ω–∏–π|—Å—Ç—Ä–∞–∂–¥–∞–Ω–Ω—è|—Å—Ç—Ä–µ—Å
üò®	–Ω–∞–ª—è–∫–∞–Ω–µ –æ–±–ª–∏—á—á—è	–±–æ—é—Å—è|–±–æ—è–∑–∫–∏–π|–Ω–∞–ª—è–∫–∞–Ω–∏–π|–æ–±–ª–∏—á—á—è|–ø–µ—Ä–µ–ª—è–∫|—Å—Ç—Ä–∞—Ö
üò©	–∑–∞–º—É—á–µ–Ω–µ –æ–±–ª–∏—á—á—è	–≤—Ç–æ–º–ª–µ–Ω–µ|–∑–∞–º—É—á–µ–Ω–µ|–∑–º–æ—Ä–µ–Ω–∏–π|–Ω–µ—â–∞—Å–Ω–∏–π|–Ω—ñ|–æ–±–ª–∏—á—á—è|–ø–æ–∑—ñ—Ö–∞—Ç–∏|—Ä–æ–∑—á–∞—Ä–æ–≤–∞–Ω–∏–π|—Ä–æ–∑—á–∞—Ä—É–≤–∞–Ω–Ω—è|—Å–ø–∞—Ç–∏|—Å—Ç–æ–º–ª–µ–Ω–∏–π|—Å—É–º–Ω–∏–π
üò™	–∑–∞—Å–ø–∞–Ω–µ –æ–±–ª–∏—á—á—è	–≤—Ç–æ–º–ª–µ–Ω–∏–∏–π|–∑–∞—Å–º—É—á–µ–Ω–∏–π|–∑–∞—Å–ø–∞–Ω–µ –æ–±–ª–∏—á—á—è|–æ–±–ª–∏—á—á—è|—Å–æ–Ω
üò´	—Å—Ç–æ–º–ª–µ–Ω–µ –æ–±–ª–∏—á—á—è	–æ–±–ª–∏—á—á—è|—Ä–æ–∑—á–∞—Ä–æ–≤–∞–Ω–∞|—Ä–æ–∑—á–∞—Ä–æ–≤–∞–Ω–∏–π|—Ä–æ–∑—á–∞—Ä—É–≤–∞–Ω–Ω—è|—Å—Ç–æ–º–ª–µ–Ω–µ –æ–±–ª–∏—á—á—è|—Å—Ç–æ–º–ª–µ–Ω–∏–π
üò¨	–æ–±–ª–∏—á—á—è –∑ –≥—Ä–∏–º–∞—Å–æ—é	–≥—Ä–∏–º–∞—Å–∞|–¥–∞–Ω—Ç–∏—Å—Ç|–¥–∏–≤–Ω–æ|–∑—É–±–∏|–∫–∞–ø–µ—Ü—å|–∫—Ä–∏–≤–ª—è–Ω–Ω—è|–∫—Ä—ñ–Ω–∂|–ø–æ—Å–º—ñ—à–∫–∞|—Å–∫—Ä–∏–≤–ª–µ–Ω–µ|—Å—Ç–æ–º–∞—Ç–æ–ª–æ–≥|—É—Å–º—ñ—à–∫–∞
üò≠	–æ–±–ª–∏—á—á—è, —â–æ –≥—É—á–Ω–æ —Ä–∏–¥–∞—î	–≥—ñ—Ä–∫–µ|–≥—É—á–Ω–æ|–∫–æ—Ç—è—Ç—å—Å—è|–Ω–µ—â–∞—Å–Ω–∏–π|–æ–±–ª–∏—á—á—è|–ø–ª–∞—á|–ø–æ—Ç—ñ–∫|—Ä–∏–¥–∞–Ω–Ω—è|—Å–ª—å–æ–∑–∏|—Å—É–º–Ω–∏–π
üòÆ	–æ–±–ª–∏—á—á—è –∑ –≤—ñ–¥–∫—Ä–∏—Ç–∏–º —Ä–æ—Ç–æ–º	–≤–∞—É|–≤—ñ–¥–∫—Ä–∏—Ç–∏–π|–∑–∞–±—É–≤|–∑–¥–∏–≤—É–≤–∞–Ω–Ω—è|–Ω–µ –º–æ–∂–µ –±—É—Ç–∏|–æ–±–ª–∏—á—á—è|–æ–≥–æ|–æ—Ç–∞–∫–æ—ó|—Ä–æ—Ç|—Å–ø—ñ–≤—á—É—Ç—Ç—è|—à–æ–∫
üòÆ‚Äçüí®	–æ–±–ª–∏—á—á—è, —â–æ –≤–∏–¥–∏—Ö–∞—î	–≤–¥–∏—Ö|–≤–∏–¥–∏—Ö|–≤–∏—Å–Ω–∞–∂–µ–Ω–∏–π|–≤—Ç–æ–º–ª–µ–Ω–∏–π|–æ–±–ª–∏—á—á—è|–ø–æ–ª–µ–≥—à–µ–Ω–Ω—è|—Å–≤–∏—Å—Ç|—Å–º–∞–π–ª|—Å—Ç–æ–≥—ñ–Ω|—Ç—É–º–∞–Ω|—à–µ–ø–æ—Ç—ñ–Ω–Ω—è
üòØ	–∑–¥–∏–≤–æ–≤–∞–Ω–µ —ñ –∑–±–µ–Ω—Ç–µ–∂–µ–Ω–µ –æ–±–ª–∏—á—á—è –∑ –±—Ä–æ–≤–∞–º–∏	–±—Ä–æ–≤–∏|–≤—Ä–∞–∂–µ–Ω–∏–π|–∑–±–µ–Ω—Ç–µ–∂–µ–Ω–µ|–∑–¥–∏–≤–æ–≤–∞–Ω–µ|–Ω—ñ—á–æ–≥–æ —Å–æ–±—ñ|–æ–±–ª–∏—á—á—è|–æ—Ç–∞–∫–æ—ó|–ø—Ä–∏–≥–æ–ª–æ–º—à–µ–Ω–∏–π
üò∞	–∑–∞–Ω–µ–ø–æ–∫–æ—î–Ω–µ –æ–±–ª–∏—á—á—è –∑ –ø–æ—Ç–æ–º	–≤—ñ–¥–∫—Ä–∏—Ç–∏–π|–∑–Ω–µ—Ä–≤–æ–≤–∞–Ω–∏–π|–Ω–µ—Ä–≤–∏|–æ–±–ª–∏—á—á—è|–ø—ñ—Ç|—Ä–æ–∑—á–∞—Ä–æ–≤–∞–Ω–∏–π|—Ä–æ—Ç|—Å–∏–Ω—ñ–π|—Å–ø—ñ—Ç–Ω—ñ—Ç–∏|—Ö–æ–ª–æ–¥–Ω–∏–π|—Ö–æ–ª–æ–¥–Ω–æ
üò±	–æ–±–ª–∏—á—á—è, —â–æ –∫—Ä–∏—á–∏—Ç—å —ñ–∑ –ø–µ—Ä–µ–ª—è–∫—É	–≤—Ä–∞–∂–µ–Ω–∏–π|–µ–ø—ñ—á–Ω–∏–π|–∑–æ–π–∫|–∫—Ä–∏–∫|–∫—Ä–∏–∫—É–Ω|–Ω–∞–ª—è–∫–∞–Ω–∏–π|–æ–±–ª–∏—á—á—è|–ø–µ—Ä–µ–ª—è–∫|—Å—Ç—Ä–∞—Ö|—à–æ–∫–æ–≤–∞–Ω–∏–π|—â–æ –∫—Ä–∏—á–∏—Ç—å
üò≤	–≤—Ä–∞–∂–µ–Ω–µ –æ–±–ª–∏—á—á—è	–∞–±—Å–æ–ª—é—Ç–Ω–æ|–≤—Ä–∞–∂–µ–Ω–µ|–∑–¥–∏–≤–æ–≤–∞–Ω–µ|–∑–¥–∏–≤–æ–≤–∞–Ω–∏–π|–Ω–µ –º–æ–∂–µ –±—É—Ç–∏|–Ω—ñ|–æ–±–ª–∏—á—á—è|–æ—Ç–∞–∫–æ—ó|–ø–æ–¥–∏–≤|—à–æ–∫
üò≥	–∑–∞—à–∞—Ä—ñ–ª–µ –æ–±–ª–∏—á—á—è	–≤–∞—É|–∑–∞—à–∞—Ä—ñ–ª–µ|–∑–¥–∏–≤–æ–≤–∞–Ω–∏–π|–Ω–µ –º–æ–∂–µ –±—É—Ç–∏|–Ω–µ–∑—Ä—É—á–Ω–∏–π|–Ω—ñ—è–∫–æ–≤–æ|–æ–±–ª–∏—á—á—è|–ø—Ä–∏—Å–æ—Ä–æ–º–ª–µ–Ω–∏–π|—Ä—É–º‚Äô—è–Ω–µ—Ü—å|—Å–æ—Ä–æ–º|—Ç–∞ –≥–æ–¥—ñ
üò¥	–æ–±–ª–∏—á—á—è, —â–æ —Å–ø–∏—Ç—å	–≤—Ç–æ–º–∞|–¥–æ–±—Ä–∞–Ω—ñ—á|–∑–∞—Å–Ω—É–≤|–Ω—ñ—á|–æ–±–ª–∏—á—á—è|—Å–æ–Ω|—Å–æ–Ω–Ω–∏–π|—Å–ø–∞—Ç–∏|—Å–ø–∏—Ç—å|—Å—Ç–æ–º–ª–µ–Ω–∏–π
üòµ	–∑–∞–ø–∞–º–æ—Ä–æ—á–µ–Ω–µ –æ–±–ª–∏—á—á—è	–∑–∞–ø–∞–º–æ—Ä–æ—á–µ–Ω–µ –æ–±–ª–∏—á—á—è|–∑–∞–ø–∞–º–æ—Ä–æ—á–µ–Ω–∏–π|–æ–±–ª–∏—á—á—è
üòµ‚Äçüí´	–æ—á—ñ-—Å–ø—ñ—Ä–∞–ª—ñ	–≥—ñ–ø–Ω–æ–∑|–∑–∞–Ω–æ—Å–∏—Ç—å|–∑–∞–ø–∞–º–æ—Ä–æ—á–µ–Ω–Ω—è|–Ω—ñ—á–æ–≥–æ —Å–æ–±—ñ|–æ–≥–æ|–æ—Ö|–æ—á—ñ-—Å–ø—ñ—Ä–∞–ª—ñ|–ø–æ–≥–∞–Ω–æ|–ø—Ä–æ–±–ª–µ–º–∞|—Å–º–∞–π–ª|—É —à–æ—Ü—ñ|—à–æ–∫
üò∂	–æ–±–ª–∏—á—á—è –±–µ–∑ —Ä–æ—Ç–∞	–±–µ–∑ —Ä–æ—Ç–∞|–±–µ–∑–∑–≤—É—á–Ω–æ|–º–æ–≤—á–∏|–Ω–µ–º–∞—î —Å–ª—ñ–≤|–æ–±–ª–∏—á—á—è|—Ä–æ—Ç|—Å–µ–∫—Ä–µ—Ç|—Ç–∏—Ö–æ
üò∑	–æ–±–ª–∏—á—á—è –≤ –º–µ–¥–∏—á–Ω—ñ–π –º–∞—Å—Ü—ñ	–≤—ñ—Ä—É—Å|–∑–∞—Å—Ç—É–¥–∞|—ñ–Ω—Ñ–µ–∫—Ü—ñ—è|–ª—ñ–∫–∞—Ä|–º–∞—Å–∫–∞|–º–µ–¥–∏—Ü–∏–Ω–∞|–æ–±–ª–∏—á—á—è –≤ –º–µ–¥–∏—á–Ω—ñ–π –º–∞—Å—Ü—ñ|—Ö–≤–æ—Ä–∏–π|—Ö–æ–ª–æ–¥–Ω–∏–π
üò∏	—à–∏—Ä–æ–∫–æ –≤—Å–º—ñ—Ö–Ω–µ–Ω–∏–π –∫—ñ—Ç –∑ —É—Å–º—ñ—Ö–æ–º –≤ –æ—á–∞—Ö	–≤–∏—à–∫—ñ—Ä|–∫—ñ—Ç|–º–æ—Ä–¥–∞|–æ–∫–æ|—É—Å–º—ñ—Ö–Ω–µ–Ω–∏–π –∫—ñ—Ç|—É—Å–º—ñ—à–∫–∞|—à–∏—Ä–æ–∫–æ –≤—Å–º—ñ—Ö–Ω–µ–Ω–∏–π –∫—ñ—Ç –∑ —É—Å–º—ñ—Ö–æ–º –≤ –æ—á–∞—Ö
üòπ	–∫—ñ—Ç –∑—ñ —Å–ª—å–æ–∑–∞–º–∏ —Ä–∞–¥–æ—Å—Ç—ñ	–∫—ñ—Ç|–∫—ñ—Ç –∑—ñ —Å–ª—å–æ–∑–∞–º–∏ —Ä–∞–¥–æ—Å—Ç—ñ|–∫—ñ—Ç —Å–º—ñ—î—Ç—å—Å—è|–º–æ—Ä–¥–∞|—Ä–∞–¥—ñ—Å—Ç—å|—Å–ª—å–æ–∑–∏|—Å–º—ñ—à–Ω–æ
üò∫	—à–∏—Ä–æ–∫–æ –≤—Å–º—ñ—Ö–Ω–µ–Ω–∏–π –∫—ñ—Ç	–≤–µ—Å–µ–ª–æ|–≤—ñ–¥–∫—Ä–∏—Ç–∏–π|–∫—ñ—Ç|–∫—ñ—à–∫–∞|–º–æ—Ä–¥–∞|–ø–∞—â–∞|–ø–æ—Å–º—ñ—à–∫–∞|—Å–º—ñ—î—Ç—å—Å—è|—É—Å–º—ñ—Ö–Ω–µ–Ω–∏–π|—É—Å–º—ñ—à–∫–∞|—à–∏—Ä–æ–∫–æ
üòª	—É—Å–º—ñ—Ö–Ω–µ–Ω–∏–π –∫—ñ—Ç –∑ –æ—á–∏–º–∞ —è–∫ —Å–µ—Ä—Ü—è	–∫—ñ—Ç|–∫–æ—Ö–∞–Ω–Ω—è|–º–æ—Ä–¥–∞|–æ–∫–æ|–ø–æ—Å–º—ñ—à–∫–∞|—Å–µ—Ä—Ü–µ|—É—Å–º—ñ—Ö–Ω–µ–Ω–∏–π –∫—ñ—Ç –∑ –æ—á–∏–º–∞ —è–∫ —Å–µ—Ä—Ü—è|—É—Å–º—ñ—à–∫–∞|—â–∞—Å–ª–∏–≤–∏–π|—â–∞—Å—Ç—è
üòº	–∫—ñ—Ç —ñ–∑ –∫—Ä–∏–≤–æ—é –ø–æ—Å–º—ñ—à–∫–æ—é	–≥–ª—É–∑–ª–∏–≤–∞|—ñ—Ä–æ–Ω—ñ—á–Ω–∏–π|–∫—ñ—Ç|–∫—ñ—Ç —ñ–∑ –∫—Ä–∏–≤–æ—é –ø–æ—Å–º—ñ—à–∫–æ—é|–∫–æ—Ç—è—á–∞|–º–æ—Ä–¥–∞|–ø–æ—Å–º—ñ—à–∫–∞|—Å–∫—Ä–∏–≤–ª–µ–Ω–∞|—Å—É–º–Ω—ñ–≤–∏
üòΩ	–∫—ñ—Ç, —â–æ —Ü—ñ–ª—É—î	–∑–∞–ø–ª—é—â–µ–Ω–∏–π|–∫—ñ—Ç|–º–æ—Ä–¥–∞|–æ–∫–æ|–æ—á—ñ|–ø–æ—Ü—ñ–ª—É–Ω–æ–∫|—Ç–≤–∞—Ä–∏–Ω–∞|—â–æ —Ü—ñ–ª—É—î
üòæ	—Å–µ—Ä–¥–∏—Ç–∏–π –∫—ñ—Ç	–∫—ñ—Ç|–∫–æ—Ç—è—á–∞|–º–æ—Ä–¥–∞|–Ω–∞—Å—É–ø–ª–µ–Ω–∏–π|—Å–µ—Ä–¥–∏—Ç–∞|—Å–µ—Ä–¥–∏—Ç–∏–π –∫—ñ—Ç
üòø	–∫—ñ—Ç, —â–æ –ø–ª–∞—á–µ	–∑–∞—Ä—é–º–∞–Ω–∞|–∫—ñ—Ç|–∫—ñ—Ç, —â–æ –ø–ª–∞—á–µ|–∫–æ—Ç—è—á–∞|–º–æ—Ä–¥–∞|–ø–ª–∞—á|—Å–ª—å–æ–∑–∞|—Å—É–º–Ω–∞|—Å—É–º–Ω–∏–π|—â–æ –ø–ª–∞—á–µ
üôÄ	—à–æ–∫–æ–≤–∞–Ω–∏–π –∫—ñ—Ç	–∑–¥–∏–≤—É–≤–∞–Ω–Ω—è|–∑–Ω–µ–Ω–∞—Ü—å–∫–∞|–∫—ñ—Ç|–∫–æ—Ç—è—á–∞|–º–æ—Ä–¥–∞|–Ω–µ –º–æ–∂–µ –±—É—Ç–∏|–æ–π|—Å—é—Ä–ø—Ä–∏–∑|—à–æ–∫|—à–æ–∫–æ–≤–∞–Ω–∏–π –∫—ñ—Ç
üôÅ	—Ç—Ä–æ—Ö–∏ –ø–æ—Ö–º—É—Ä–µ –æ–±–ª–∏—á—á—è	–Ω–∞—Ö–º—É—Ä–µ–Ω–∏–π|–æ–±–ª–∏—á—á—è|—Å—É–º–Ω–∏–π|—Ç—Ä–æ—Ö–∏ –ø–æ—Ö–º—É—Ä–µ –æ–±–ª–∏—á—á—è
üôÇ	—Ç—Ä–æ—Ö–∏ –≤—Å–º—ñ—Ö–Ω–µ–Ω–µ –æ–±–ª–∏—á—á—è	–≤—Å–º—ñ—Ö–Ω–µ–Ω–∏–π|–∑–∞–¥–æ–≤–æ–ª–µ–Ω–∏–π|–æ–±–ª–∏—á—á—è|–ø–æ—Å–º—ñ—à–∫–∞|—Å–º—ñ—Ö|—É—Å–º—ñ—Ö–Ω–µ–Ω–∏–π|—É—Å–º—ñ—à–∫–∞
üôÉ	–æ–±–ª–∏—á—á—è –¥–æ–≥–æ—Ä–∏ –¥—Ä–∏“ë–æ–º	–¥–æ–≥–æ—Ä–∏ –¥–Ω–æ–º|–¥–æ–≥–æ—Ä–∏ –¥—Ä–∏“ë–æ–º|–¥–æ–≥–æ—Ä–∏ –Ω–æ–≥–∞–º–∏|–æ–±–ª–∏—á—á—è|—Ö–∞—Ö–∞|—Ö–µ—Ö–µ
üôÑ	–æ–±–ª–∏—á—á—è —ñ–∑ –∑–∞–∫–æ—á–µ–Ω–∏–º–∏ –æ—á–∏–º–∞	–±–∞–π–¥—É–∂–µ|–∑–∞–∫–æ—á—É–≤–∞—Ç–∏|–æ –±–æ–∂–µ|–æ–±–ª–∏—á—á—è|–æ—Ç–∞–∫–æ—ó|–æ—Ü–µ —Ç–∞–∫|–æ—á—ñ
üôÖ	–ª—é–¥–∏–Ω–∞, —â–æ –∂–µ—Å—Ç–æ–º –ø–æ–∫–∞–∑—É—î ¬´–Ω—ñ¬ª	–∂–µ—Å—Ç|–∑–∞–±–æ—Ä–æ–Ω–µ–Ω–æ|–ª—é–¥–∏–Ω–∞|–ª—é–¥–∏–Ω–∞, —â–æ –∂–µ—Å—Ç–æ–º –ø–æ–∫–∞–∑—É—î ¬´–Ω—ñ¬ª|–Ω–µ–º–∞—î —à–∞–Ω—Å—ñ–≤|–Ω—ñ|–Ω—ñ–∫–æ–ª–∏|—Ä—É–∫–∞|—â–æ –∂–µ—Å—Ç–æ–º –ø–æ–∫–∞–∑—É—î ¬´–Ω—ñ¬ª
üôÜ	–ª—é–¥–∏–Ω–∞, —â–æ –∂–µ—Å—Ç–æ–º –ø–æ–∫–∞–∑—É—î ¬´–æ–∫–µ–π¬ª	–≤–ø—Ä–∞–≤–∞|–∂–µ—Å—Ç|–ª—é–¥–∏–Ω–∞|–ª—é–¥–∏–Ω–∞ –ø–æ–∫–∞–∑—É—î –æ–∫–µ–π|–ª—é–¥–∏–Ω–∞, —â–æ –∂–µ—Å—Ç–æ–º –ø–æ–∫–∞–∑—É—î ¬´–æ–∫–µ–π¬ª|–æ–∫–µ–π|—Ä—É–∫–∞|—Ö–æ–≤–∞—Ç–∏—Å—è|—â–æ –∂–µ—Å—Ç–æ–º –ø–æ–∫–∞–∑—É—î ¬´–æ–∫–µ–π¬ª
üôá	–ª—é–¥–∏–Ω–∞, —â–æ –≤–∫–ª–æ–Ω—è—î—Ç—å—Å—è	–±–ª–∞–≥–∞—Ç–∏|–≤–∏–±–∞—á|–∂–∞–ª–∫—É–≤–∞—Ç–∏|–∂–µ—Å—Ç|–ø–æ–∫–ª–æ–Ω|—Ä–æ–∑–∫–∞—è–Ω–Ω—è|—Å–ø—ñ–≤—á—É–≤–∞—Ç–∏|—É–∫–ª—ñ–Ω|—à–∫–æ–¥–∞
üôà	–º–∞–≤–ø–∞, —â–æ –Ω–µ –±–∞—á–∏—Ç—å	–±–∞—á–∏—Ç–∏|–∑–∞–±–æ—Ä–æ–Ω–µ–Ω–æ|–∑–ª–æ|–º–∞–≤–ø–∞|–º–∞–≤–ø–∞, —â–æ –Ω–µ –±–∞—á–∏—Ç—å|–Ω–µ –±–∞—á—É|–Ω–µ –±–∞—á—É –∑–ª–∞|–æ–±–ª–∏—á—á—è|—â–æ –Ω–µ –±–∞—á–∏—Ç—å|—â–æ –Ω–µ –±–∞—á–∏—Ç—å –∑–ª–∞
üôâ	–º–∞–≤–ø–∞, —â–æ –Ω–µ —á—É—î	–∑–∞–±–æ—Ä–æ–Ω–µ–Ω–æ|–∑–ª–æ|–º–∞–≤–ø–∞|–º–∞–≤–ø–∞, —â–æ –Ω–µ —á—É—î|–Ω–µ —á—É—é|–Ω–µ —á—É—é –∑–ª–∞|–æ–±–ª–∏—á—á—è|—á—É—Ç–∏|—â–æ –Ω–µ —á—É—î|—â–æ –Ω–µ —á—É—î –∑–ª–∞
üôä	–º–∞–≤–ø–∞, —â–æ –Ω–µ –≥–æ–≤–æ—Ä–∏—Ç—å	–≥–æ–≤–æ—Ä–∏—Ç–∏|–∑–∞–±–æ—Ä–æ–Ω–µ–Ω–æ|–∑–ª–æ|–º–∞–≤–ø–∞|–º–æ–≤—á—É|–Ω–µ –≥–æ–≤–æ—Ä—é –ª–∏—Ö–æ–≥–æ|–Ω–µ —Å–∫–∞–∂—É|–æ–±–ª–∏—á—á—è|–æ–π|—Å–µ–∫—Ä–µ—Ç|—â–æ –Ω–µ –≤–∏—Å–ª–æ–≤–ª—é—î –∑–ª–∞|—â–æ –Ω–µ –≥–æ–≤–æ—Ä–∏—Ç—å
üôã	–ª—é–¥–∏–Ω–∞ –∑ –ø—ñ–¥–Ω—è—Ç–æ—é —Ä—É–∫–æ—é	–≤–∏–±–µ—Ä—ñ—Ç—å|–≤—ñ—Ç–∞–Ω–Ω—è|–∂–µ—Å—Ç|–∑–∞–ø–∏—Ç–∞–Ω–Ω—è|–º–µ–Ω–µ|–º–æ–∂—É|–æ–±–µ—Ä—ñ—Ç—å|—Ç—É—Ç|—â–∞—Å–ª–∏–≤–∏–π
üôå	—Ä—É–∫–∏, –ø—ñ–¥–Ω—è—Ç—ñ –¥–ª—è —Å–≤—è—Ç–∫—É–≤–∞–Ω–Ω—è	–∂–µ—Å—Ç|–ø—ñ–¥–Ω—è—Ç–∞|–ø—ñ–¥–Ω—è—Ç—ñ –¥–ª—è —Å–≤—è—Ç–∫—É–≤–∞–Ω–Ω—è|–ø—ñ–¥–Ω—è—Ç—ñ —Ä—É–∫–∏|—Ä—É–∫–∞|—Ä—É–∫–∏|—Ä—É–∫–∏, –ø—ñ–¥–Ω—è—Ç—ñ –¥–ª—è —Å–≤—è—Ç–∫—É–≤–∞–Ω–Ω—è|—Å–≤—è—Ç–∫—É–≤–∞–Ω–Ω—è|—É—Ä–∞
üôç	–ø–æ—Ö–º—É—Ä–∞ –ª—é–¥–∏–Ω–∞	–∂–µ—Å—Ç|–∑–∞—Å–º—É—á–µ–Ω–∏–π|–Ω–∞—Å—É–ø–ª–µ–Ω—ñ –±—Ä–æ–≤–∏|–Ω–∞—Ö–º—É—Ä–µ–Ω–∏–π|–Ω–µ–≤–¥–æ–≤–æ–ª–µ–Ω–∏–π|–Ω–µ–≤–µ—Å–µ–ª–∏–π|–ø–æ—Ö–º—É—Ä–∞ –ª—é–¥–∏–Ω–∞|—Ä–æ–∑–¥—Ä–∞—Ç—É–≤–∞–Ω–Ω—è|—Å–º—É—Ç–æ–∫
üôé	–ª—é–¥–∏–Ω–∞, —â–æ –¥—É—î—Ç—å—Å—è	–≥—Ä–∏–º–∞—Å–∞|–∂–µ—Å—Ç|–∑–∞—Å–º—É—á–µ–Ω–∏–π|–∑–ª–∏–π|–Ω–∞—Å—É–ø–ª–µ–Ω–∏–π|–Ω–µ–≤–µ—Å–µ–ª–∏–π|–ø–æ—Ö–º—É—Ä–∏–π|—Ä–æ–∑—á–∞—Ä–æ–≤–∞–Ω–∏–π|—Å—Ç—É—Ä–±–æ–≤–∞–Ω–∏–π|—Å—É–º–Ω–æ
üôè	—Ä—É–∫–∏, —Å—Ç–∏—Å–Ω—É—Ç—ñ —Ä–∞–∑–æ–º	–±–ª–∞–≥–∞–Ω–Ω—è|–±—É–¥—å –ª–∞—Å–∫–∞|–¥—è–∫—É—é|–º–æ–ª–∏—Ç–≤–∞|–ø—Ä–æ—Å–∏—Ç–∏|–ø—Ä–æ—à—É|—Ä—É–∫–∞|—É–∫–ª—ñ–Ω
üöÄ	—Ä–∞–∫–µ—Ç–∞	–∑–∞–ø—É—Å–∫ —Ä–∞–∫–µ—Ç–∏|–∫–æ—Å–º–æ—Å|–ø–æ–¥–æ—Ä–æ–∂|—Ä–∞–∫–µ—Ç–∞|—Ç—Ä–∞–Ω—Å–ø–æ—Ä—Ç
üöÅ	–≥–µ–ª—ñ–∫–æ–ø—Ç–µ—Ä	–≤–µ—Ä—Ç–æ–ª—ñ—Ç|–≥–µ–ª—ñ–∫–æ–ø—Ç–µ—Ä|—Ç—Ä–∞–Ω—Å–ø–æ—Ä—Ç
üöÇ	–ø–∞—Ä–æ–≤–∏–π –ª–æ–∫–æ–º–æ—Ç–∏–≤	–¥–≤–∏–≥—É–Ω|–∑–∞–ª—ñ–∑–Ω–∏—Ü—è|–ø–∞—Ä–æ–≤–∏–π|–ø–∞—Ä–æ–≤–∏–π –ª–æ–∫–æ–º–æ—Ç–∏–≤|–ø–∞—Ä–æ–≤–æ–∑|–ø–æ—Ç—è–≥|—Ç—Ä–∞–Ω—Å–ø–æ—Ä—Ç
üöÉ	–≤–∞–≥–æ–Ω	–≤–∞–≥–æ–Ω|–µ–ª–µ–∫—Ç—Ä–∏—á–Ω–∏–π|–∑–∞–ª—ñ–∑–Ω–∏—Ü—è|—Ç—Ä–∞–º–≤–∞–π|—Ç—Ä–∞–Ω—Å–ø–æ—Ä—Ç|—Ç—Ä–æ–ª–µ–π–±—É—Å
üöÑ	—à–≤–∏–¥–∫—ñ—Å–Ω–∏–π –ø–æ—Ç—è–≥	–∑–∞–ª—ñ–∑–Ω–∏—Ü—è|—ñ–Ω—Ç–µ—Ä—Å—ñ—Ç—ñ|–ø–æ—Ç—è–≥|—Ç—Ä–∞–Ω—Å–ø–æ—Ä—Ç|—à–≤–∏–¥–∫—ñ—Å–Ω–∏–π
üöÖ	—à–≤–∏–¥–∫—ñ—Å–Ω–∏–π –ø–æ—Ç—è–≥ –∑ –æ–∫—Ä—É–≥–ª–∏–º –Ω–æ—Å–æ–º	–∑–∞–ª—ñ–∑–Ω–∏—Ü—è|—ñ–Ω—Ç–µ—Ä—Å—ñ—Ç—ñ|–∫—É–ª–µ–ø–æ–¥—ñ–±–Ω–∏–π|–ø–æ—Ç—è–≥|—Ç—Ä–∞–Ω—Å–ø–æ—Ä—Ç|—à–≤–∏–¥–∫—ñ—Å–Ω–∏–π|—à–≤–∏–¥–∫—ñ—Å–Ω–∏–π –ø–æ—Ç—è–≥ –∑ –æ–∫—Ä—É–≥–ª–∏–º –Ω–æ—Å–æ–º
üöÜ	–ø–æ—Ç—è–≥	–µ–ª–µ–∫—Ç—Ä–æ–ø–æ—Ç—è–≥|–∑–∞–ª—ñ–∑–Ω–∏—Ü—è|–ø–æ—Ç—è–≥|—Ç—Ä–∞–Ω—Å–ø–æ—Ä—Ç
üöá	–º–µ—Ç—Ä–æ	–º–µ—Ç—Ä–æ|—Ç—Ä–∞–Ω—Å–ø–æ—Ä—Ç
üöà	—à–≤–∏–¥–∫—ñ—Å–Ω–∏–π —Ç—Ä–∞–º–≤–∞–π	–µ–ª–µ–∫—Ç—Ä–æ–ø–æ—ó–∑–¥|–∑–∞–ª—ñ–∑–Ω–∏—Ü—è|–ø–æ—ó–∑–¥|—Ç—Ä–∞–Ω—Å–ø–æ—Ä—Ç|—à–≤–∏–¥–∫—ñ—Å–Ω–∏–π —Ç—Ä–∞–º–≤–∞–π
üöâ	—Å—Ç–∞–Ω—Ü—ñ—è	c—Ç–∞–Ω—Ü—ñ—è|–∑–∞–ª—ñ–∑–Ω–∏—Ü—è|–∑—É–ø–∏–Ω–∫–∞|–ø–æ—Ç—è–≥|—Å—Ç–∞–Ω—Ü—ñ—è|—Ç—Ä–∞–Ω—Å–ø–æ—Ä—Ç
üöä	—Ç—Ä–∞–º–≤–∞–π	–º–µ—Ç—Ä–æ|–ø–æ—Ç—è–≥|—Ç—Ä–∞–º–≤–∞–π|—Ç—Ä–∞–Ω—Å–ø–æ—Ä—Ç|—Ç—Ä–æ–ª–µ–π–±—É—Å
üöã	–≤–∞–≥–æ–Ω —Ç—Ä–∞–º–≤–∞—è	–≤–∞–≥–æ–Ω|–≤–∞–≥–æ–Ω —Ç—Ä–∞–º–≤–∞—è|—Ç—Ä–∞–º–≤–∞–π|—Ç—Ä–∞–Ω—Å–ø–æ—Ä—Ç|—Ç—Ä–æ–ª–µ–π–±—É—Å
üöå	–∞–≤—Ç–æ–±—É—Å	–∞–≤—Ç–æ–±—É—Å|—Ç—Ä–∞–Ω—Å–ø–æ—Ä—Ç
üöç	–∞–≤—Ç–æ–±—É—Å, —â–æ –Ω–∞–±–ª–∏–∂–∞—î—Ç—å—Å—è	–∞–≤—Ç–æ–±—É—Å|–º–∞—à–∏–Ω–∏|—â–æ –Ω–∞–±–ª–∏–∂–∞—î—Ç—å—Å—è|—â–æ –Ω–∞–±–ª–∏–∂–∞—é—Ç—å—Å—è
üöé	—Ç—Ä–æ–ª–µ–π–±—É—Å	–∞–≤—Ç–æ–±—É—Å|–≥—Ä–æ–º–∞–¥—Å—å–∫–∏–π —Ç—Ä–∞–Ω—Å–ø–æ—Ä—Ç|—Ç—Ä–∞–º–≤–∞–π|—Ç—Ä–∞–Ω—Å–ø–æ—Ä—Ç|—Ç—Ä–æ–ª–µ–π–±—É—Å
üöè	–∞–≤—Ç–æ–±—É—Å–Ω–∞ –∑—É–ø–∏–Ω–∫–∞	–∞–≤—Ç–æ–±—É—Å|–∞–≤—Ç–æ–±—É—Å–Ω–∞ –∑—É–ø–∏–Ω–∫–∞|–∑—É–ø–∏–Ω–∫–∞
üöê	–º—ñ–∫—Ä–æ–∞–≤—Ç–æ–±—É—Å	–∞–≤—Ç–æ–±—É—Å|–º–∞—Ä—à—Ä—É—Ç–∫–∞|–º—ñ–∫—Ä–æ–∞–≤—Ç–æ–±—É—Å|—Ç—Ä–∞–Ω—Å–ø–æ—Ä—Ç
üöë	–∞–≤—Ç–æ–º–æ–±—ñ–ª—å —à–≤–∏–¥–∫–æ—ó –¥–æ–ø–æ–º–æ–≥–∏	–∞–≤—Ç–æ–º–æ–±—ñ–ª—å —à–≤–∏–¥–∫–æ—ó –¥–æ–ø–æ–º–æ–≥–∏|—Ç—Ä–∞–Ω—Å–ø–æ—Ä—Ç|—à–≤–∏–¥–∫–∞ –¥–æ–ø–æ–º–æ–≥–∞
üöí	–ø–æ–∂–µ–∂–Ω–∞ –º–∞—à–∏–Ω–∞	–≤–∞–Ω—Ç–∞–∂—ñ–≤–∫–∞|–¥–≤–∏–≥—É–Ω|–ø–æ–∂–µ–∂–Ω–∞ –º–∞—à–∏–Ω–∞|–ø–æ–∂–µ–∂–Ω–∏–π|–ø–æ–∂–µ–∂–Ω–∏–π –∞–≤—Ç–æ–º–æ–±—ñ–ª—å
üöì	–ø–æ–ª—ñ—Ü–µ–π—Å—å–∫–∞ –º–∞—à–∏–Ω–∞	–∞–≤—Ç–æ–º–æ–±—ñ–ª—å|–º—ñ–ª—ñ—Ü—ñ—è|–ø–∞—Ç—Ä—É–ª—å|–ø–∞—Ç—Ä—É–ª—å–Ω–∏–π –∞–≤—Ç–æ–º–æ–±—ñ–ª—å|–ø–æ–ª—ñ—Ü–µ–π—Å—å–∫–∞ –º–∞—à–∏–Ω–∞|–ø–æ–ª—ñ—Ü–µ–π—Å—å–∫–∏–π –∞–≤—Ç–æ–º–æ–±—ñ–ª—å|–ø–æ–ª—ñ—Ü—ñ—è
üöî	–ø–æ–ª—ñ—Ü–µ–π—Å—å–∫–∞ –º–∞—à–∏–Ω–∞, —â–æ –Ω–∞–±–ª–∏–∂–∞—î—Ç—å—Å—è	–∞–≤—Ç–æ–º–æ–±—ñ–ª—å|–º—ñ–ª—ñ—Ü—ñ—è|–Ω–∞–±–ª–∏–∂–∞—î—Ç—å—Å—è|–ø–∞—Ç—Ä—É–ª—å|–ø–æ–ª—ñ—Ü–µ–π—Å—å–∫–∞ –º–∞—à–∏–Ω–∞|–ø–æ–ª—ñ—Ü–µ–π—Å—å–∫–∞ –º–∞—à–∏–Ω–∞, —â–æ –Ω–∞–±–ª–∏–∂–∞—î—Ç—å—Å—è|–ø–æ–ª—ñ—Ü–µ–π—Å—å–∫–∏–π –∞–≤—Ç–æ–º–æ–±—ñ–ª—å|–ø–æ–ª—ñ—Ü—ñ—è|—â–æ –Ω–∞–±–ª–∏–∂–∞—î—Ç—å—Å—è
üöï	—Ç–∞–∫—Å—ñ	—Ç–∞–∫—Å—ñ|—Ç—Ä–∞–Ω—Å–ø–æ—Ä—Ç
üöñ	—Ç–∞–∫—Å—ñ, —â–æ –Ω–∞–±–ª–∏–∂–∞—î—Ç—å—Å—è	–∂–æ–≤—Ç–µ —Ç–∞–∫—Å—ñ|–Ω–∞–±–ª–∏–∂–∞—Ç–∏—Å—è|—Ç–∞–∫—Å—ñ|—Ç–∞–∫—Å—ñ, —â–æ –Ω–∞–±–ª–∏–∂–∞—î—Ç—å—Å—è|—Ç—Ä–∞–Ω—Å–ø–æ—Ä—Ç|—â–æ –Ω–∞–±–ª–∏–∂–∞—î—Ç—å—Å—è
üöó	–∞–≤—Ç–æ–º–æ–±—ñ–ª—å	–∞–≤—Ç—ñ–≤–∫–∞|–∞–≤—Ç–æ|–∞–≤—Ç–æ–º–æ–±—ñ–ª—å|–º–∞—à–∏–Ω–∞|—Ç—Ä–∞–Ω—Å–ø–æ—Ä—Ç
üöò	–∞–≤—Ç–æ–º–æ–±—ñ–ª—å, —â–æ –Ω–∞–±–ª–∏–∂–∞—î—Ç—å—Å—è	–∞–≤—Ç–æ–º–æ–±—ñ–ª—å|–∞–≤—Ç–æ–º–æ–±—ñ–ª—å, —â–æ –Ω–∞–±–ª–∏–∂–∞—î—Ç—å—Å—è|–º–∞—à–∏–Ω–∞|–Ω–∞–±–ª–∏–∂–∞—î—Ç—å—Å—è|—Ç—Ä–∞–Ω—Å–ø–æ—Ä—Ç|—á–µ—Ä–≤–æ–Ω–∞ –º–∞—à–∏–Ω–∞|—á–µ—Ä–≤–æ–Ω–µ –∞–≤—Ç–æ|—â–æ –Ω–∞–±–ª–∏–∂–∞—î—Ç—å—Å—è
üöô	–ø–æ–∑–∞—à–ª—è—Ö–æ–≤–∏–∫	–∞–≤—Ç—ñ–≤–∫–∞|–∂–∏—Ç–ª–æ–≤–∏–π|–º–∞—à–∏–Ω–∞|–ø–æ–∑–∞—à–ª—è—Ö–æ–≤–∏–∫|—Ç—Ä–∞–Ω—Å–ø–æ—Ä—Ç|—Ç—Ä–µ–π–ª–µ—Ä|—Ñ—É—Ä–≥–æ–Ω
üöö	–≤–∞–Ω—Ç–∞–∂—ñ–≤–∫–∞ –¥–ª—è –¥–æ—Å—Ç–∞–≤–∫–∏	–≤–∞–Ω—Ç–∞–∂—ñ–≤–∫–∞|–≤–∞–Ω—Ç–∞–∂—ñ–≤–∫–∞ –¥–ª—è –¥–æ—Å—Ç–∞–≤–∫–∏|–¥–æ—Å—Ç–∞–≤–∫–∞|—Ç—Ä–∞–Ω—Å–ø–æ—Ä—Ç|—Ñ—É—Ä–≥–æ–Ω
üöõ	–≤–∞–Ω—Ç–∞–∂—ñ–≤–∫–∞ –∑ –ø—Ä–∏—á–µ–ø–æ–º	–≤–∞–Ω—Ç–∞–∂—ñ–≤–∫–∞|–≤–∞–Ω—Ç–∞–∂—ñ–≤–∫–∞ –∑ –ø—Ä–∏—á–µ–ø–æ–º|—Ç—Ä–∞–Ω—Å–ø–æ—Ä—Ç|—Ç—è–≥–∞—á|—Ñ—É—Ä–≥–æ–Ω
üöú	—Ç—Ä–∞–∫—Ç–æ—Ä	—Ç—Ä–∞–∫—Ç–æ—Ä|—Ç—Ä–∞–Ω—Å–ø–æ—Ä—Ç
üöù	–º–æ–Ω–æ—Ä–µ–π–∫–∞	–º–µ—Ç—Ä–æ|–º–æ–Ω–æ—Ä–µ–π–∫–∞|–º–æ–Ω–æ—Ä–µ–π–∫–æ–≤–∞ –∑–∞–ª—ñ–∑–Ω–∏—Ü—è|—Ç—Ä–∞–Ω—Å–ø–æ—Ä—Ç|—à–≤–∏–¥–∫–∏–π –ø–æ—Ç—è–≥
üöû	–∑–∞–ª—ñ–∑–Ω–∏—Ü—è –≤ –≥–æ—Ä–∞—Ö	–≤–∞–≥–æ–Ω|–≥—ñ—Ä—Å—å–∫–∞ –∑–∞–ª—ñ–∑–Ω–∏—Ü—è|–≥–æ—Ä–∞|–∑–∞–ª—ñ–∑–Ω–∏—Ü—è|–∑–∞–ª—ñ–∑–Ω–∏—Ü—è –≤ –≥–æ—Ä–∞—Ö|–ø–æ—ó–∑–¥|—Ç—Ä–∞–Ω—Å–ø–æ—Ä—Ç
üöü	–ø—ñ–¥–≤—ñ—Å–Ω–∞ –º–æ–Ω–æ—Ä–µ–π–∫–∞	–∑–∞–ª—ñ–∑–Ω–∏—Ü—è|–∫–∞–Ω–∞—Ç–Ω–∞ –¥–æ—Ä–æ–≥–∞|–ø—ñ–¥–≤—ñ—Å–Ω–∞ –∑–∞–ª—ñ–∑–Ω–∏—Ü—è|–ø—ñ–¥–≤—ñ—Å–Ω–∞ –º–æ–Ω–æ—Ä–µ–π–∫–∞|–ø—ñ–¥–≤—ñ—Å–Ω–∏–π|—Ç—Ä–∞–Ω—Å–ø–æ—Ä—Ç
üö†	–∫–∞–Ω–∞—Ç–Ω–∞ –¥–æ—Ä–æ–≥–∞ –≤ –≥–æ—Ä–∞—Ö	–≥–æ–Ω–¥–æ–ª–∞|–≥–æ—Ä–∞|–∫–∞–±–µ–ª—å|–∫–∞–Ω–∞—Ç–Ω–∞ –¥–æ—Ä–æ–≥–∞|–∫–∞–Ω–∞—Ç–Ω–∞ –¥–æ—Ä–æ–≥–∞ –≤ –≥–æ—Ä–∞—Ö|—Ç—Ä–∞–Ω—Å–ø–æ—Ä—Ç|—Ñ—É–Ω—ñ–∫—É–ª–µ—Ä
üö°	–∫–∞–Ω–∞—Ç–Ω–∞ –¥–æ—Ä–æ–≥–∞	–∞–≤—Ç–æ–º–æ–±—ñ–ª—å|–≥–æ–Ω–¥–æ–ª–∞|–∫–∞–±–µ–ª—å|–∫–∞–Ω–∞—Ç–Ω–∞ –¥–æ—Ä–æ–≥–∞|–ø—ñ–¥–≤—ñ—Å–Ω–∞ –¥–æ—Ä–æ–≥–∞|–ø—ñ–¥–≤—ñ—Å–Ω–∞ –∫–∞–Ω–∞—Ç–Ω–∞ –¥–æ—Ä–æ–≥–∞|–ø–æ–≤—ñ—Ç—Ä—è–Ω–∏–π|—Ç—Ä–∞–Ω—Å–ø–æ—Ä—Ç
üö¢	–∫–æ—Ä–∞–±–µ–ª—å	–∫–æ—Ä–∞–±–µ–ª—å|—Ç—Ä–∞–Ω—Å–ø–æ—Ä—Ç
üö£	–ª—é–¥–∏–Ω–∞, —â–æ –≤–µ—Å–ª—É—î –Ω–∞ —á–æ–≤–Ω—ñ	–±–∞–π–¥–∞—Ä–∫–∞|–≤–µ—Å–ª–æ|–≥—Ä–µ–±–ª—è|–∫–∞–Ω–æ–µ|–ª—é–¥–∏–Ω–∞|–æ–∑–µ—Ä–æ|—Ä–∞—Ñ—Ç|—Ä–∏–±–∞–ª–∫–∞|—Ä—ñ—á–∫–∞|—Ç—Ä–∞–Ω—Å–ø–æ—Ä—Ç|—á–æ–≤–µ–Ω
üö§	—à–≤–∏–¥–∫–æ—Ö—ñ–¥–Ω–∏–π –∫–∞—Ç–µ—Ä	–∫–∞—Ç–µ—Ä|—Ç—Ä–∞–Ω—Å–ø–æ—Ä—Ç|—á–æ–≤–µ–Ω|—à–≤–∏–¥–∫–æ—Ö—ñ–¥–Ω–∏–π –∫–∞—Ç–µ—Ä
üö•	–≥–æ—Ä–∏–∑–æ–Ω—Ç–∞–ª—å–Ω–∏–π —Å–≤—ñ—Ç–ª–æ—Ñ–æ—Ä	–≥–æ—Ä–∏–∑–æ–Ω—Ç–∞–ª—å–Ω–∏–π —Å–≤—ñ—Ç–ª–æ—Ñ–æ—Ä|—Å–≤—ñ—Ç–ª–æ—Ñ–æ—Ä|—Ç—Ä–∞–Ω—Å–ø–æ—Ä—Ç
üö¶	–≤–µ—Ä—Ç–∏–∫–∞–ª—å–Ω–∏–π —Å–≤—ñ—Ç–ª–æ—Ñ–æ—Ä	–≤–µ—Ä—Ç–∏–∫–∞–ª—å–Ω–∏–π —Å–≤—ñ—Ç–ª–æ—Ñ–æ—Ä|–ø–µ—Ä–µ—Ö—Ä–µ—Å—Ç—è|–ø—ñ—à–æ—Ö—ñ–¥–Ω–∏–π –ø–µ—Ä–µ—Ö—ñ–¥|—Å–≤—ñ—Ç–ª–æ—Ñ–æ—Ä|—Ç—Ä–∞–Ω—Å–ø–æ—Ä—Ç
üöß	–∑–Ω–∞–∫ —Ä–µ–º–æ–Ω—Ç–Ω–∏—Ö —Ä–æ–±—ñ—Ç	–±—É–¥—ñ–≤–Ω–∏—Ü—Ç–≤–æ|–∑–Ω–∞–∫ —Ä–µ–º–æ–Ω—Ç–Ω–∏—Ö —Ä–æ–±—ñ—Ç|–æ–≥–æ—Ä–æ–∂–∞|–ø–∞—Ä–∫–∞–Ω|–ø—Ä–æ—Ö—ñ–¥ –∑–∞–±–æ—Ä–æ–Ω–µ–Ω–æ
üö®	–ø—Ä–æ–±–ª–∏—Å–∫–æ–≤–∏–π –º–∞—è—á–æ–∫	–∞–≤—Ç–æ–º–æ–±—ñ–ª—å|–≤–æ–≥–Ω—ñ –ø–æ–ª—ñ—Ü–µ–π—Å—å–∫–æ–≥–æ –∞–≤—Ç–æ–º–æ–±—ñ–ª—è|–º–∞—è–∫|–º–∞—è–∫ –ø–∞—Ç—Ä—É–ª—å–Ω–æ–≥–æ –∞–≤—Ç–æ–º–æ–±—ñ–ª—è|–º–∏–≥–∞—Ç–∏|–æ–±–µ—Ä—Ç–∞—Ç–∏—Å—è|–ø–æ–ª—ñ—Ü—ñ—è|–ø—Ä–æ–±–ª–∏—Å–∫–æ–≤–∏–π –º–∞—è—á–æ–∫|—Å–∏—Ä–µ–Ω–∞|—à–≤–∏–¥–∫–∞
üö©	—Ç—Ä–∏–∫—É—Ç–Ω–∏–π –ø—Ä–∞–ø–æ—Ä	–≥–æ–ª—å—Ñ|–ø—Ä–∞–ø–æ—Ä–µ—Ü—å|—Å–∏–≥–Ω–∞–ª|—Ç—Ä–∏–∫—É—Ç–Ω–∏–π|—Ñ–ª–∞–≥—à—Ç–æ–∫
üö™	–¥–≤–µ—Ä—ñ	–≤—Ö—ñ–¥|–¥–≤–µ—Ä—ñ
üö´	–∑–∞–±–æ—Ä–æ–Ω–µ–Ω–æ	–≤ º—ó–∑–¥ –∑–∞–±–æ—Ä–æ–Ω–µ–Ω–æ|–∑–∞–±–æ—Ä–æ–Ω–µ–Ω–æ|–∑–∞–±–æ—Ä–æ–Ω—è—î—Ç—å—Å—è|–Ω–µ –¥–æ–∑–≤–æ–ª–µ–Ω–æ|–Ω–µ –¥–æ–ø—É—Å–∫–∞—î—Ç—å—Å—è|–Ω–µ–º–∞—î|–Ω—ñ
üö¨	—Å–∏–≥–∞—Ä–µ—Ç–∞	–∫—É—Ä—ñ–Ω–Ω—è|–ø–∞–ª—ñ–Ω–Ω—è|—Å–∏–≥–∞—Ä–µ—Ç–∞|—Ü–∏–≥–∞—Ä–∫–∞
üö≠	–ø–∞–ª–∏—Ç–∏ –∑–∞–±–æ—Ä–æ–Ω–µ–Ω–æ	–∑–∞–±–æ—Ä–æ–Ω–µ–Ω–æ|–∫—É—Ä–∏—Ç–∏|–Ω–µ|–ø–∞–ª–∏—Ç–∏|–ø–∞–ª—ñ–Ω–Ω—è –∑–∞–±–æ—Ä–æ–Ω–µ–Ω–æ|—Å–∏–º–≤–æ–ª ¬´–Ω–µ –ø–∞–ª–∏—Ç–∏¬ª
üöÆ	–∑–Ω–∞–∫ –∫–∏–¥–∞—Ç–∏ —Å–º—ñ—Ç—Ç—è –≤ —É—Ä–Ω—É	–∑–Ω–∞–∫ –∫–∏–¥–∞—Ç–∏ —Å–º—ñ—Ç—Ç—è –≤ —É—Ä–Ω—É|–ø–∞–º º—è—Ç–∫–∞ –Ω–µ —Å–º—ñ—Ç–∏—Ç–∏|—Å–º—ñ—Ç–Ω–∏–∫|—Å–º—ñ—Ç—Ç—è|—É—Ä–Ω–∞
üöØ	—Å–º—ñ—Ç–∏—Ç–∏ –∑–∞–±–æ—Ä–æ–Ω–µ–Ω–æ	–∑–∞–±–æ—Ä–æ–Ω–µ–Ω–æ|–∑–Ω–∞–∫ ¬´–Ω–µ —Å–º—ñ—Ç–∏—Ç–∏¬ª|–Ω–µ|—Å–º—ñ—Ç–∏—Ç–∏|—Å–º—ñ—Ç—Ç—è
üö∞	–ø–∏—Ç–Ω–∞ –≤–æ–¥–∞	–≤–æ–¥–∞|–∫—Ä–∞–Ω|–ø–∏—Ç–Ω–∞|–ø–∏—Ç–Ω–∏–π|–ø—Ä–∏–¥–∞—Ç–Ω–∞ –¥–ª—è –ø–∏—Ç—Ç—è
üö±	–Ω–µ–ø—Ä–∏–¥–∞—Ç–Ω–∞ –¥–ª—è –ø–∏—Ç—Ç—è –≤–æ–¥–∞	–≤–æ–¥–∞|–∑–∞–±–æ—Ä–æ–Ω–µ–Ω–æ|–∑–Ω–∞–∫ ¬´–Ω–µ–ø–∏—Ç–Ω–∞ –≤–æ–¥–∞¬ª|–Ω–µ|–Ω–µ–ø–∏—Ç–Ω–∞ –≤–æ–¥–∞|–Ω–µ–ø—Ä–∏–¥–∞—Ç–Ω–∞ –¥–ª—è –ø–∏—Ç—Ç—è –≤–æ–¥–∞|–Ω–µ–ø—Ä–∏–¥–∞—Ç–Ω–æ|–ø–∏—Ç–∏|–ø–∏—Ç—Ç—è
üö≤	–≤–µ–ª–æ—Å–∏–ø–µ–¥	–≤–µ–ª–æ—Å–∏–ø–µ–¥|–∫–∞—Ç–∞—Ç–∏—Å—è|—Ç—Ä–∞–Ω—Å–ø–æ—Ä—Ç
üö≥	–≤–µ–ª–æ—Å–∏–ø–µ–¥–∏ –∑–∞–±–æ—Ä–æ–Ω–µ–Ω–æ	–≤–µ–ª–æ—Å–∏–ø–µ–¥|–≤–µ–ª–æ—Å–∏–ø–µ–¥–∏ –∑–∞–±–æ—Ä–æ–Ω–µ–Ω–æ|–∑–∞–±–æ—Ä–æ–Ω–µ–Ω–æ|—Ä—É—Ö –Ω–∞ –≤–µ–ª–æ—Å–∏–ø–µ–¥—ñ –∑–∞–±–æ—Ä–æ–Ω–µ–Ω–æ|—Ç—Ä–∞–Ω—Å–ø–æ—Ä—Ç–Ω–∏–π –∑–∞—Å—ñ–±
üö¥	–ª—é–¥–∏–Ω–∞, —â–æ —ó–¥–µ –Ω–∞ –≤–µ–ª–æ—Å–∏–ø–µ–¥—ñ	–≤–µ–ª–æ—Å–∏–ø–µ–¥|–≤–µ–ª–æ—Å–∏–ø–µ–¥–∏—Å—Ç|—ó–∑–¥–∞ –Ω–∞ –≤–µ–ª–æ—Å–∏–ø–µ–¥—ñ|–∫–∞—Ç–∞—Ç–∏—Å—è –Ω–∞ –≤–µ–ª–æ—Å–∏–ø–µ–¥—ñ|–ª—é–¥–∏–Ω–∞|–ª—é–¥–∏–Ω–∞ –Ω–∞ –≤–µ–ª–æ—Å–∏–ø–µ–¥—ñ|–ª—é–¥–∏–Ω–∞, —â–æ —ó–¥–µ –Ω–∞ –≤–µ–ª–æ—Å–∏–ø–µ–¥—ñ|—Å–ø–æ—Ä—Ç—Å–º–µ–Ω|—â–æ —ó–¥–µ –Ω–∞ –≤–µ–ª–æ—Å–∏–ø–µ–¥—ñ
üöµ	–ª—é–¥–∏–Ω–∞, —â–æ —ó–¥–µ –Ω–∞ –≥—ñ—Ä—Å—å–∫–æ–º—É –≤–µ–ª–æ—Å–∏–ø–µ–¥—ñ	–≤–µ–ª–æ—Å–∏–ø–µ–¥|–≤–µ–ª–æ—Å–∏–ø–µ–¥–∏—Å—Ç|–≥—ñ—Ä—Å—å–∫–∏–π –≤–µ–ª–æ—Å–∏–ø–µ–¥|–≥–æ—Ä–∞|—ó–∑–¥–∞ –Ω–∞ –≤–µ–ª–æ—Å–∏–ø–µ–¥—ñ|–∫–∞—Ç–∞—Ç–∏—Å—è –Ω–∞ –≤–µ–ª–æ—Å–∏–ø–µ–¥—ñ|–ª—é–¥–∏–Ω–∞|–ª—é–¥–∏–Ω–∞, —â–æ —ó–¥–µ –Ω–∞ –≥—ñ—Ä—Å—å–∫–æ–º—É –≤–µ–ª–æ—Å–∏–ø–µ–¥—ñ|—Å–ø–æ—Ä—Ç—Å–º–µ–Ω|—â–æ —ó–¥–µ –Ω–∞ –≥—ñ—Ä—Å—å–∫–æ–º—É –≤–µ–ª–æ—Å–∏–ø–µ–¥—ñ
üö∂	–ª—é–¥–∏–Ω–∞, —â–æ –π–¥–µ –ø—ñ—à–∫–∏	–≥—É–ª—è—Ç–∏|—ñ—Ç–∏|–∫—Ä–æ–∫|–ª—é–¥–∏–Ω–∞|–ª—é–¥–∏–Ω–∞ –π–¥–µ|–ª—é–¥–∏–Ω–∞, —â–æ –π–¥–µ –ø—ñ—à–∫–∏|–ø—ñ—à–∫–∏|–ø—ñ—à–æ—Ö—ñ–¥|–ø—Ä–æ–≥—É–ª—è–Ω–∫–∞|—â–æ –π–¥–µ –ø—ñ—à–∫–∏
üö∑	–ø—ñ—à–æ—Ö—ñ–¥–Ω–∏–π —Ä—É—Ö –∑–∞–±–æ—Ä–æ–Ω–µ–Ω–æ	–∑–∞–±–æ—Ä–æ–Ω–µ–Ω–æ|–ø—ñ—à–æ—Ö—ñ–¥–Ω–∏–π —Ä—É—Ö –∑–∞–±–æ—Ä–æ–Ω–µ–Ω–æ|–ø—Ä–æ—Ö—ñ–¥ –∑–∞–±–æ—Ä–æ–Ω–µ–Ω–æ|—Ä—É—Ö –∑–∞–±–æ—Ä–æ–Ω–µ–Ω–æ|—Ä—É—Ö –ø—ñ—à–æ—Ö–æ–¥—ñ–≤ –∑–∞–±–æ—Ä–æ–Ω–µ–Ω–æ
üö∏	–ø–æ–ø–µ—Ä–µ–¥–∂—É–≤–∞–ª—å–Ω–∏–π –∑–Ω–∞–∫ ¬´–î—ñ—Ç–∏¬ª	–¥—ñ—Ç–∏|–¥—ñ—Ç–∏ –Ω–∞ –¥–æ—Ä–æ–∑—ñ|–Ω–∞ –¥–æ—Ä–æ–∑—ñ|–ø–µ—Ä–µ—Ö—ñ–¥ –¥–æ—Ä–æ–≥–∏ –¥–ª—è –¥—ñ—Ç–µ–π|–ø—ñ—à–æ—Ö–æ–¥–∏|–ø–æ–ø–µ—Ä–µ–¥–∂—É–≤–∞–ª—å–Ω–∏–π –∑–Ω–∞–∫ ¬´–î—ñ—Ç–∏¬ª|—Ä—É—Ö
üöπ	—á–æ–ª–æ–≤—ñ—á–∞ –≤–±–∏—Ä–∞–ª—å–Ω—è	–≤–±–∏—Ä–∞–ª—å–Ω—è|–¥–ª—è —á–æ–ª–æ–≤—ñ–∫—ñ–≤|–∫–ª–æ–∑–µ—Ç|—Ç—É–∞–ª–µ—Ç|—Ç—É–∞–ª–µ—Ç–Ω–∞ –∫—ñ–º–Ω–∞—Ç–∞|—á–æ–ª–æ–≤—ñ—á–∞ –≤–±–∏—Ä–∞–ª—å–Ω—è|—á–æ–ª–æ–≤—ñ—á–∏–π —Ç—É–∞–ª–µ—Ç
üö∫	–∂—ñ–Ω–æ—á–∞ –≤–±–∏—Ä–∞–ª—å–Ω—è	–≤–±–∏—Ä–∞–ª—å–Ω—è|–¥–ª—è –∂—ñ–Ω–æ–∫|–∂—ñ–Ω–æ—á–∞ –≤–±–∏—Ä–∞–ª—å–Ω—è|–∂—ñ–Ω–æ—á–∏–π —Ç—É–∞–ª–µ—Ç|—Ç—É–∞–ª–µ—Ç|—É–±–∏—Ä–∞–ª—å–Ω—è
üöª	–≥—Ä–æ–º–∞–¥—Å—å–∫–∏–π —Ç—É–∞–ª–µ—Ç	–≤–±–∏—Ä–∞–ª—å–Ω—è|–≥—Ä–æ–º–∞–¥—Å—å–∫–∏–π —Ç—É–∞–ª–µ—Ç|–∫–ª–æ–∑–µ—Ç|—Ç—É–∞–ª–µ—Ç
üöº	—Å–∏–º–≤–æ–ª –Ω–µ–º–æ–≤–ª—è—Ç–∏	–¥–ª—è –Ω–µ–º–æ–≤–ª—è—Ç|–∑–∞–º—ñ–Ω–∞ –ø–µ–ª—é—à–æ–∫|–Ω–µ–º–æ–≤–ª—è|–ø–µ–ª–µ–Ω–∞–Ω–Ω—è|—Å–∏–º–≤–æ–ª ¬´–Ω–µ–º–æ–≤–ª—è¬ª|—Å–∏–º–≤–æ–ª –Ω–µ–º–æ–≤–ª—è—Ç–∏
üöΩ	—É–Ω—ñ—Ç–∞–∑	—Ç—É–∞–ª–µ—Ç|—É–Ω—ñ—Ç–∞–∑
üöæ	—Å–∏–º–≤–æ–ª —É–±–∏—Ä–∞–ª—å–Ω—ñ [WC]	–≤–∞–Ω–Ω–∞|–≤–±–∏—Ä–∞–ª—å–Ω—è|–∑–Ω–∞–∫ —É–±–∏—Ä–∞–ª—å–Ω—ñ WC|–∫—ñ–º–Ω–∞—Ç–∞|—Å–∏–º–≤–æ–ª —É–±–∏—Ä–∞–ª—å–Ω—ñ [WC]|—Å–∏–º–≤–æ–ª —É–±–∏—Ä–∞–ª—å–Ω—ñ WC|—Ç—É–∞–ª–µ—Ç–Ω–∞ –∫—ñ–º–Ω–∞—Ç–∞|—É–±–∏—Ä–∞–ª—å–Ω—è
üöø	–¥—É—à	–≤–æ–¥–∞|–¥—É—à
üõÄ	–ª—é–¥–∏–Ω–∞, —â–æ –ø—Ä–∏–π–º–∞—î –≤–∞–Ω–Ω—É	–≤–∞–Ω–Ω–∞|–∫—É–ø–∞—Ç–∏—Å—è|–ª—é–¥–∏–Ω–∞|–ª—é–¥–∏–Ω–∞, —â–æ –ø—Ä–∏–π–º–∞—î –≤–∞–Ω–Ω—É|–ø—Ä–∏–π–º–∞—Ç–∏ –≤–∞–Ω–Ω—É|—â–æ –ø—Ä–∏–π–º–∞—î –≤–∞–Ω–Ω—É
üõÅ	–≤–∞–Ω–Ω–∞	–≤–∞–Ω–Ω–∞|–≤–∞–Ω–Ω–∞ –∑ –ø—ñ–Ω–æ—é|–∫—É–ø–∞—Ç–∏—Å—è|–ø—Ä–∏–π–º–∞—Ç–∏ –≤–∞–Ω–Ω—É
üõÇ	–ø–∞—Å–ø–æ—Ä—Ç–Ω–∏–π –∫–æ–Ω—Ç—Ä–æ–ª—å	–∫–æ–Ω—Ç—Ä–æ–ª—å|–º–∏—Ç–Ω–∏—Ü—è|–ø–∞—Å–ø–æ—Ä—Ç–Ω–∏–π
üõÉ	–º–∏—Ç–Ω–∏—Ü—è	–º–∏—Ç–Ω–∏–π –∫–æ–Ω—Ç—Ä–æ–ª—å|–º–∏—Ç–Ω–∏—Ü—è
üõÑ	–≤–∏–¥–∞—á–∞ –±–∞–≥–∞–∂—É	–±–∞–≥–∞–∂|–≤–∏–¥–∞—á–∞|–≤–∏–¥–∞—á–∞ –±–∞–≥–∞–∂—É|–æ—Ç—Ä–∏–º–∞–Ω–Ω—è|–ø—É–Ω–∫—Ç –æ—Ç—Ä–∏–º–∞–Ω–Ω—è –±–∞–≥–∞–∂—É
üõÖ	–∫–∞–º–µ—Ä–∞ —Å—Ö–æ–≤—É	–±–∞–≥–∞–∂|–∑–∞–ª–∏—à–µ–Ω—ñ —Ä–µ—á—ñ|–∫–∞–º–µ—Ä–∞ –∑–±–µ—Ä—ñ–≥–∞–Ω–Ω—è|–∫–∞–º–µ—Ä–∞ —Å—Ö–æ–≤—É|–∫–æ–º—ñ—Ä–∫–∞ –¥–ª—è –∑–±–µ—Ä—ñ–≥–∞–Ω–Ω—è|–ø–æ–∫–ª–∞–∂–∞
üõå	–ª—é–¥–∏–Ω–∞ –≤ –ª—ñ–∂–∫—É	–≤—ñ–¥–ø–æ—á–∏–Ω–æ–∫|–≥–æ—Ç–µ–ª—å|–¥–æ–±—Ä–∞–Ω—ñ—á|–ª—ñ–∂–∫–æ|–ª—é–¥–∏–Ω–∞ –≤ –ª—ñ–∂–∫—É|–Ω—ñ—á|—Å–æ–Ω|—Å–ø–∞—Ç–∏|—Å—Ç–æ–º–ª–µ–Ω–∏–π
üõê	–∫—É–ª—å—Ç–æ–≤–∞ —Å–ø–æ—Ä—É–¥–∞	–∫—É–ª—å—Ç–æ–≤–∞ —Å–ø–æ—Ä—É–¥–∞|–º–æ–ª–∏—Ç–≤–∞|–º–æ–ª–∏—Ç–∏—Å—è|–º–æ–ª–∏—Ç–æ–≤–Ω–∏–π –¥—ñ–º|–ø–æ–∫–ª–æ–Ω—ñ–Ω–Ω—è|—Ä–µ–ª—ñ–≥—ñ—è
üõë	–≤–æ—Å—å–º–∏–∫—É—Ç–Ω–∏–π —á–µ—Ä–≤–æ–Ω–∏–π –∑–Ω–∞–∫	–≤–æ—Å—å–º–∏–∫—É—Ç–Ω–∏–π —á–µ—Ä–≤–æ–Ω–∏–π –∑–Ω–∞–∫|–≤–æ—Å—å–º–∏–∫—É—Ç–Ω–∏–∫|–∑–Ω–∞–∫|–∑–Ω–∞–∫ ‚Äú—Å—Ç–æ–ø‚Äù|—Å—Ç–æ–ø
üõí	–º–∞–≥–∞–∑–∏–Ω–Ω–∏–π –≤—ñ–∑–æ–∫	–≤–æ–∑–∏–∫|–º–∞–≥–∞–∑–∏–Ω|–º–∞–≥–∞–∑–∏–Ω–Ω–∏–π –≤—ñ–∑–æ–∫|—Å—É–ø–µ—Ä–º–∞—Ä–∫–µ—Ç|—à–æ–ø—ñ–Ω–≥
üõï	—ñ–Ω–¥—É—ó—Å—Ç—Å—å–∫–∏–π —Ö—Ä–∞–º	—ñ–Ω–¥—É—ó—Å—Ç—Å—å–∫–∏–π|—Ö—Ä–∞–º
üõñ	—Ö–∏–∂–∞	–±—É–¥–∏–Ω–æ–∫|–±—É–Ω–≥–∞–ª–æ|–¥—ñ–º|–∫—É–ø–æ–ª—å–Ω–∏–π –±—É–¥–∏–Ω–æ–∫|–æ—Å–µ–ª—è|–ø—Ä–∏—Ö–∏—Å—Ç–æ–∫|—Ö–∞—Ç–∞|—Ö–∞—Ç–∏–Ω–∞|—Ö–∏–∂–∞|—é—Ä—Ç–∞
üõó	–ª—ñ—Ñ—Ç	–≤–∞–Ω—Ç–∞–∂–Ω—ñ—Å—Ç—å|–¥–æ—Å—Ç—É–ø–Ω—ñ—Å—Ç—å|–ª—é–¥–∏|–ø–∞—Å–∞–∂–∏—Ä–∏|–ø—ñ–¥—ñ–π–º–∞—á|–ø—ñ–¥–π–æ–º–Ω–∏–∫|—Å–ø–µ—Ü—ñ–∞–ª—å–Ω—ñ –º–æ–∂–ª–∏–≤–æ—Å—Ç—ñ
üõú	–±–µ–∑–¥—Ä–æ—Ç–æ–≤–∏–π	wifi|wlan|–±–µ–∑–ø—Ä–æ–≤—ñ–¥–Ω–∏–π|–≤–∞–π—Ñ–∞–π|–∑ º—î–¥–Ω–∞–Ω–Ω—è|—ñ–Ω—Ç–µ—Ä–Ω–µ—Ç|–º–∞—Ä—à—Ä—É—Ç–∏–∑–∞—Ç–æ—Ä|–º–µ—Ä–µ–∂–∞|—Å–º–∞—Ä—Ç—Ñ–æ–Ω|—Ç–æ—á–∫–∞ –¥–æ—Å—Ç—É–ø—É|—Ö–æ—Ç—Å–ø–æ—Ç
üõù	–¥–∏—Ç—è—á–∞ –≥—ñ—Ä–∫–∞	–≥—ñ—Ä–∫–∞|–≥—Ä–∞—Ç–∏—Å—è|–¥–∏—Ç—è—á–∞ –≥—ñ—Ä–∫–∞|–∑ º—ó–∂–¥–∂–∞—Ç–∏ –∑ –≥—ñ—Ä–∫–∏|—ñ–≥—Ä–æ–≤–∏–π –º–∞–π–¥–∞–Ω—á–∏–∫|–∫–∞—Ç–∞—Ç–∏—Å—è|–ø–∞—Ä–∫ —Ä–æ–∑–≤–∞–≥
üõû	–∫–æ–ª–µ—Å–æ	–∞–≤—Ç–æ–º–æ–±—ñ–ª—å|–∫–æ–ª–µ—Å–æ|–∫–æ–ª–æ|–º–∞—à–∏–Ω–∞|–æ–±–µ—Ä—Ç–∞—Ç–∏—Å—è|—Ç—Ä–∞–Ω—Å–ø–æ—Ä—Ç|—à–∏–Ω–∞
üõü	—Ä—è—Ç—ñ–≤–Ω–∏–π –∫—Ä—É–≥	–±–µ–∑–ø–µ–∫–∞|–±—É–π–æ–∫|–ø–ª–∞–≤–∞—Ç–∏|—Ä—è—Ç—ñ–≤–Ω–µ –∫–æ–ª–æ|—Ä—è—Ç—ñ–≤–Ω–∏–∫|—Ä—è—Ç—É–≤–∞–ª—å–Ω–∏–π –∑–∞—Å—ñ–±|—Ä—è—Ç—É–≤–∞—Ç–∏ –∂–∏—Ç—Ç—è|—Å–ø–∞—Å–∞—Ç–∏|—Ç—Ä–∏–º–∞—Ç–∏—Å—è –Ω–∞ –≤–æ–¥—ñ
üõ´	–ª—ñ—Ç–∞–∫ –∑–ª—ñ—Ç–∞—î	–≤—ñ–¥–ø—Ä–∞–≤–ª–µ–Ω–Ω—è|–≤—ñ–¥–ø—Ä–∞–≤–ª–µ–Ω–Ω—è –ª—ñ—Ç–∞–∫–∞|–ª—ñ—Ç–∞–∫|–ª—ñ—Ç–∞–∫ –∑–ª—ñ—Ç–∞—î|–ø–æ–¥–æ—Ä–æ–∂|–ø–æ–ª—ñ—Ç|—Ä–µ—î—Å—Ç—Ä–∞—Ü—ñ—è|—Ç—Ä–∞–Ω—Å–ø–æ—Ä—Ç
üõ¨	–ª—ñ—Ç–∞–∫ —Å—ñ–¥–∞—î	–ª—ñ—Ç–∞–∫|–ª—ñ—Ç–∞–∫ —Å—ñ–¥–∞—î|–ø–æ–¥–æ—Ä–æ–∂|–ø—Ä–∏–±—É—Ç—Ç—è|–ø—Ä–∏–±—É—Ç—Ç—è –ª—ñ—Ç–∞–∫–∞|–ø—Ä–∏–∑–µ–º–ª–µ–Ω–Ω—è|—Ç—Ä–∞–Ω—Å–ø–æ—Ä—Ç
üõ¥	—Å–∞–º–æ–∫–∞—Ç	—Å–∞–º–æ–∫–∞—Ç
üõµ	–º–æ–ø–µ–¥	–º–æ–ø–µ–¥|—Å–∫—É—Ç–µ—Ä
üõ∂	–∫–∞–Ω–æ–µ	–∫–∞–Ω–æ–µ|—á–æ–≤–µ–Ω
üõ∑	—Å–∞–Ω–∏	—Å–∞–Ω–∏|—Å–∞–Ω—á–∞—Ç–∞|—Å–Ω—ñ–≥
üõ∏	–ª–µ—Ç—é—á–∞ —Ç–∞—Ä—ñ–ª–∫–∞	–ª–µ—Ç—é—á–∞ —Ç–∞—Ä—ñ–ª–∫–∞|–ù–õ–û|—á—É–∂—ñ
üõπ	—Å–∫–µ–π—Ç–±–æ—Ä–¥	–±–æ—Ä–¥|–¥–æ—à–∫–∞|–∫–æ–ª—ñ—â–∞—Ç–∫–∞|—Ä–æ–ª–∏–∫–∏|—Å–∫–µ–π—Ç|—Å–∫–µ–π—Ç–±–æ—Ä–¥|—Å–∫–µ–π—Ç–µ—Ä
üõ∫	–∞–≤—Ç–æ—Ä–∏–∫—à–∞	–∞–≤—Ç–æ—Ä–∏–∫—à–∞|—Ä–∏–∫—à–∞|—Ç—É–∫-—Ç—É–∫
üõª	–∞–≤—Ç–æ–º–æ–±—ñ–ª—å-–ø—ñ–∫–∞–ø	–∞–≤—Ç–æ–º–æ–±—ñ–ª—å|–∞–≤—Ç–æ–º–æ–±—ñ–ª—å-–ø—ñ–∫–∞–ø|–≤–∞–Ω—Ç–∞–∂|–≤–∞–Ω—Ç–∞–∂—ñ–≤–∫–∞|–ª–µ–≥–∫–∞ –≤–∞–Ω—Ç–∞–∂—ñ–≤–∫–∞|–ø—ñ–∫–∞–ø|—Ç—Ä–∞–Ω—Å–ø–æ—Ä—Ç
üõº	—Ä–æ–ª–∏–∫–æ–≤–∏–π –∫–æ–≤–∑–∞–Ω	–∫–∞—Ç–∞–Ω–Ω—è|–∫–∞—Ç–∞–Ω–Ω—è –Ω–∞ —Ä–æ–ª–∏–∫–∞—Ö|–∫–æ–≤–∑–∞–Ω|–∫–æ–≤–∑–∞–Ω–∏|–∫–æ–ª—ñ—â–∞—Ç–∞|—Ä–æ–ª–∏–∫–∏|—Ä–æ–ª–∏–∫–æ–≤–∏–π|—Å–ø–æ—Ä—Ç
üü†	–æ—Ä–∞–Ω–∂–µ–≤–∏–π –∫—Ä—É–≥	–∫—Ä—É–≥|–æ—Ä–∞–Ω–∂–µ–≤–∏–π
üü°	–∂–æ–≤—Ç–∏–π –∫—Ä—É–≥	–∂–æ–≤—Ç–∏–π|–∫—Ä—É–≥
üü¢	–∑–µ–ª–µ–Ω–∏–π –∫—Ä—É–≥	–∑–µ–ª–µ–Ω–∏–π|–∫—Ä—É–≥
üü£	—Ñ—ñ–æ–ª–µ—Ç–æ–≤–∏–π –∫—Ä—É–≥	–∫—Ä—É–≥|–ø—É—Ä–ø—É—Ä–æ–≤–∏–π|—Ñ—ñ–æ–ª–µ—Ç–æ–≤–∏–π
üü§	–∫–æ—Ä–∏—á–Ω–µ–≤–∏–π –∫—Ä—É–≥	–∫–æ—Ä–∏—á–Ω–µ–≤–∏–π|–∫—Ä—É–≥
üü•	—á–µ—Ä–≤–æ–Ω–∏–π –∫–≤–∞–¥—Ä–∞—Ç	–∫–≤–∞–¥—Ä–∞—Ç|—á–µ—Ä–≤–æ–Ω–∏–π
üü¶	—Å–∏–Ω—ñ–π –∫–≤–∞–¥—Ä–∞—Ç	–±–ª–∞–∫–∏—Ç–Ω–∏–π|–∫–≤–∞–¥—Ä–∞—Ç|—Å–∏–Ω—ñ–π
üüß	–æ—Ä–∞–Ω–∂–µ–≤–∏–π –∫–≤–∞–¥—Ä–∞—Ç	–∫–≤–∞–¥—Ä–∞—Ç|–æ—Ä–∞–Ω–∂–µ–≤–∏–π
üü®	–∂–æ–≤—Ç–∏–π –∫–≤–∞–¥—Ä–∞—Ç	–∂–æ–≤—Ç–∏–π|–∫–≤–∞–¥—Ä–∞—Ç
üü©	–∑–µ–ª–µ–Ω–∏–π –∫–≤–∞–¥—Ä–∞—Ç	–∑–µ–ª–µ–Ω–∏–π|–∫–≤–∞–¥—Ä–∞—Ç
üü™	—Ñ—ñ–æ–ª–µ—Ç–æ–≤–∏–π –∫–≤–∞–¥—Ä–∞—Ç	–∫–≤–∞–¥—Ä–∞—Ç|—Ñ—ñ–æ–ª–µ—Ç–æ–≤–∏–π
üü´	–∫–æ—Ä–∏—á–Ω–µ–≤–∏–π –∫–≤–∞–¥—Ä–∞—Ç	–∫–≤–∞–¥—Ä–∞—Ç|–∫–æ—Ä–∏—á–Ω–µ–≤–∏–π
üü∞	–∑–Ω–∞–∫ —Ç–æ—á–Ω–æ—ó —Ä—ñ–≤–Ω–æ—Å—Ç—ñ	–≤—ñ–¥–ø–æ–≤—ñ–¥—å|–¥–æ—Ä—ñ–≤–Ω—é—î|–∑–Ω–∞–∫ —Ç–æ—á–Ω–æ—ó —Ä—ñ–≤–Ω–æ—Å—Ç—ñ|–º–∞—Ç–µ–º–∞—Ç–∏–∫–∞|—Ä–µ–∑—É–ª—å—Ç–∞—Ç|—Ä—ñ–≤–Ω—ñ—Å—Ç—å|—Ä—ñ–≤–Ω–æ–∑–Ω–∞—á–Ω–∏–π
ü§å	–∑–≤–µ–¥–µ–Ω—ñ –ø–∞–ª—å—Ü—ñ	–¥–æ–ª–æ–Ω—è|–∂–µ—Å—Ç|–∑–∞–ø–∏—Ç–∞–Ω–Ω—è|–ª–æ—Ç–æ—Å|–º—É–¥—Ä–∞|–ø—Ä–æ—Å–≤—ñ—Ç–ª–µ–Ω–Ω—è|—Ä–æ–∑—Å–ª–∞–±–ª–µ–Ω–Ω—è|—Ä—É–∫–∞|—Å–∞—Ä–∫–∞–∑–º|—Å–ø–æ–∫—ñ–π|—Ç–µ—Ä–ø—ñ–Ω–Ω—è
ü§ç	–±—ñ–ª–µ —Å–µ—Ä—Ü–µ	–±—ñ–ª–µ|—Å–µ—Ä—Ü–µ
ü§é	–∫–æ—Ä–∏—á–Ω–µ–≤–µ —Å–µ—Ä—Ü–µ	–∫–æ—Ä–∏—á–Ω–µ–≤–µ|—Å–µ—Ä—Ü–µ
ü§è	–∂–µ—Å—Ç ¬´–º–∞–ª–æ¬ª	–¥–µ—â–∏—Ü—è|–∂–µ—Å—Ç ¬´–º–∞–ª–æ¬ª|–º–∞–ª–æ|–Ω–µ–±–∞–≥–∞—Ç–æ|–Ω–µ–≤–µ–ª–∏–∫–∞ –∫—ñ–ª—å–∫—ñ—Å—Ç—å|–ø–∞–ª—å—Ü—ñ|—Ä—É–∫–∞|—Ç—Ä–æ—Ö–∏|—â—ñ–ø–∫–∞
ü§ê	–æ–±–ª–∏—á—á—è —ñ–∑ –∑–∞—Å—Ç—ñ–±–∫–æ—é –∑–∞–º—ñ—Å—Ç—å —Ä–æ—Ç–∞	–±–ª–∏—Å–∫–∞–≤–∫–∞|–∑–∞—Å—Ç—ñ–±–∫–∞|–º–æ–≤—á–∞—Ç–∏|–º–æ–≤—á—É|–Ω–µ –∫–∞–∑–∞—Ç–∏|–Ω–µ —Å–∫–∞–∂—É|–æ–±–ª–∏—á—á—è|—Ä–æ—Ç|—Ä–æ—Ç –Ω–∞ –∑–∞–º–æ–∫|—è–∫ —Ä–∏–±–∞
ü§ë	–æ–±–ª–∏—á—á—è –∑ –≥—Ä—ñ—à–º–∏ –∑–∞–º—ñ—Å—Ç—å –æ—á–µ–π —Ç–∞ —è–∑–∏–∫–∞	–≤–¥–∞–≤–∏—Å—è|–≤–∏–≥—Ä–∞—à|–≥—Ä–æ—à—ñ|–ª–æ—Ç–µ—Ä–µ—è|–æ–±–ª–∏—á—á—è|–æ—á—ñ|—Ä–æ—Ç
ü§í	–æ–±–ª–∏—á—á—è –∑ —Ç–µ—Ä–º–æ–º–µ—Ç—Ä–æ–º	–æ–±–ª–∏—á—á—è|–æ–±–ª–∏—á—á—è –∑ —Ç–µ—Ä–º–æ–º–µ—Ç—Ä–æ–º|—Ç–µ—Ä–º–æ–º–µ—Ç—Ä|—Ö–≤–æ—Ä–∏–π
ü§ì	–æ–±–ª–∏—á—á—è –≤—Å–µ–∑–Ω–∞–π–∫–∞	–±–æ—Ç–∞–Ω|–≥—ñ–∫|–¥–æ–π–¥–∞|–¥–æ–∫–∞|–∑–∞—Ü—ñ–∫–∞–≤–ª–µ–Ω—ñ—Å—Ç—å|–Ω–∞–≤—á–∞–Ω–Ω—è|–æ–±–ª–∏—á—á—è|–æ–±–ª–∏—á—á—è –≤—Å–µ–∑–Ω–∞–π–∫–∞|–æ–±–ª–∏—á—á—è –∑–∞—É—á–∫–∏|—É–Ω—ñ–∫—É–º
ü§î	–æ–±–ª–∏—á—á—è –≤ —Ä–æ–∑–¥—É–º–∞—Ö	–¥–∞–π –ø–æ–¥—É–º–∞—é|–¥—É–º–∞—Ç–∏|–∑–∞–¥—É–º–∞|–Ω–µ –∑–Ω–∞—é|–æ–±–ª–∏—á—á—è|–ø—ñ–¥–±–æ—Ä—ñ–¥–¥—è|—Ä–æ–∑–¥—É–º–∏|—Ç—Ä–µ–±–∞ –ø–æ–¥—É–º–∞—Ç–∏|—É —Ä–æ–∑–¥—É–º–∞—Ö|—Ö–º
ü§ï	–æ–±–ª–∏—á—á—è –∑ –≥–æ–ª–æ–≤–Ω–æ—é –ø–æ–≤ º—è–∑–∫–æ—é	–±–æ–ª–∏—Ç—å|–≥–æ–ª–æ–≤–∞|–æ–±–ª–∏—á—á—è|–ø–æ–≤‚Äô—è–∑–∫–∞|–ø–æ—Ä–∞–Ω–µ–Ω–∏–π|—Ä–∞–Ω–∞|—Ç—Ä–∞–≤–º–∞
ü§ñ	—Ä–æ–±–æ—Ç	–≥–æ–ª–æ–≤–∞|–º–æ–Ω—Å—Ç—Ä|–æ–±–ª–∏—á—á—è|—Ä–æ–±–æ—Ç
ü§ó	—â–∞—Å–ª–∏–≤–µ –æ–±–ª–∏—á—á—è –∑ —Ä—É–∫–∞–º–∏, —â–æ –æ–±—ñ–π–º–∞—é—Ç—å	–æ–±—ñ–π–º–∞—Ç–∏—Å—è|–æ–±—ñ–π–º–∏|–æ–±—ñ–π–Ω—è–≤|–æ–±–ª–∏—á—á—è|–æ–±–Ω—è—Ç–∏|—Ä–∞–¥—ñ—Å–Ω–∏–π|—Ä–∞–¥—ñ—Å—Ç—å|—Ä—É–∫–∏|—â–∞—Å—Ç—è
ü§ò	–∂–µ—Å—Ç ¬´—Ä–æ–≥–∏¬ª	–∂–µ—Å—Ç ¬´—Ä–æ–≥–∏¬ª|–∫–æ–∑–∞|–ø–∞–ª–µ—Ü—å|—Ä–æ–≥–∏|—Ä–æ–∫|—Ä–æ–∫-–Ω-—Ä–æ–ª|—Ä—É–∫–∞|—Å–∏–º–≤–æ–ª —Ä–æ–≥—ñ–≤ —Ä—É–∫–æ—é
ü§ô	–∂–µ—Å—Ç ¬´–ø–æ–¥–∑–≤–æ–Ω–∏ –º–µ–Ω—ñ¬ª	–∂–µ—Å—Ç ¬´–ø–æ–¥–∑–≤–æ–Ω–∏ –º–µ–Ω—ñ¬ª|–∂–µ—Å—Ç —Ä—É–∫–æ—é ¬´–ø–æ–¥–∑–≤–æ–Ω–∏ –º–µ–Ω—ñ¬ª|–∑–∞—Ç–µ–ª–µ—Ñ–æ–Ω—É–π –º–µ–Ω—ñ|–∑—ñ–∑–≤–æ–Ω–µ–º–æ—Å—è|–ø–æ–¥–∑–≤–æ–Ω–∏ –º–µ–Ω—ñ|—Ä—É–∫–∞|—Ç–µ–ª–µ—Ñ–æ–Ω
ü§ö	–ø—ñ–¥–Ω—è—Ç–∞ —Ä—É–∫–∞ —Ç–∏–ª—å–Ω–æ—é —Å—Ç–æ—Ä–æ–Ω–æ—é	–¥–æ–ª–æ–Ω—è|–ø—ñ–¥–Ω—è—Ç–∞|–ø—ñ–¥–Ω—è—Ç–∞ —Ä—É–∫–∞ —Ç–∏–ª—å–Ω–æ—é —Å—Ç–æ—Ä–æ–Ω–æ—é|—Ä—É–∫–∞|—Ç–∏–ª—å–Ω–∞
ü§õ	–∫—É–ª–∞–∫ —É–ª—ñ–≤–æ	–∫—É–ª–∞–∫|–ø–∞–Ω—á|—Ä—É–∫–∞|—É–ª—ñ–≤–æ
ü§ú	–∫—É–ª–∞–∫ —É–ø—Ä–∞–≤–æ	–∫—É–ª–∞–∫|—Ä—É–∫–∞|—É–¥–∞—Ä –ø—Ä–∞–≤–æ—Ä—É—á|—É–ø—Ä–∞–≤–æ
ü§ù	—Ä—É–∫–æ—Å—Ç–∏—Å–∫–∞–Ω–Ω—è	–¥–æ–º–æ–≤–∏–ª–∏—Å—è|–∑–≥–æ–¥–∞|–ø–æ —Ä—É–∫–∞—Ö|–ø–æ—Ç–∏—Å–∫–∞–Ω–Ω—è|—Ä—É–∫–∏|—Ä—É–∫–æ—Å—Ç–∏—Å–∫–∞–Ω–Ω—è
ü§û	—Å—Ö—Ä–µ—â–µ–Ω—ñ –ø–∞–ª—å—Ü—ñ	–ø–∞–ª—å—Ü—ñ|—Ä—É–∫–∞|—Å—Ö—Ä–µ—â–µ–Ω—ñ|—É–¥–∞—á–∞
ü§ü	–∂–µ—Å—Ç ¬´–∫–æ—Ö–∞—é —Ç–µ–±–µ¬ª	–∂–µ—Å—Ç|–∂–µ—Å—Ç ¬´–∫–æ—Ö–∞—é —Ç–µ–±–µ¬ª|–ø—ñ–¥–Ω—è—Ç–∞ —Ä—É–∫–∞|—Ä—É–∫–∞|—Ç—Ä–∏ –ø–∞–ª—å—Ü—ñ|—Ñ–∞–Ω–∞—Ç
ü§†	–æ–±–ª–∏—á—á—è —É –∫–æ–≤–±–æ–π—Å—å–∫–æ–º—É –∫–∞–ø–µ–ª—é—Å—ñ	–∫–∞–ø–µ–ª—é—Ö|–∫–æ–≤–±–æ–π|–æ–±–ª–∏—á—á—è|–æ–±–ª–∏—á—á—è —É –∫–æ–≤–±–æ–π—Å—å–∫–æ–º—É –∫–∞–ø–µ–ª—é—Å—ñ|—à–∏—Ä–æ–∫–æ —É—Å–º—ñ—Ö–Ω–µ–Ω–µ –æ–±–ª–∏—á—á—è —É –∫–æ–≤–±–æ–π—Å—å–∫–æ–º—É –∫–∞–ø–µ–ª—é—Å—ñ
ü§°	–æ–±–ª–∏—á—á—è –∫–ª–æ—É–Ω–∞	–∫–ª–æ—É–Ω|–æ–±–ª–∏—á—á—è|–æ–±–ª–∏—á—á—è –∫–ª–æ—É–Ω–∞|—Ü–∏—Ä–∫
ü§¢	–æ–±–ª–∏—á—á—è, —è–∫–µ –Ω—É–¥–∏—Ç—å	–±–ª—é–≤–æ—Ç–∞|–∑–∞–∫–∞—á—É—î|–Ω—É–¥–∏—Ç—å|–Ω—É–¥–æ—Ç–∞|–æ–±–ª–∏—á—á—è|–ø–æ–≥–∞–Ω–æ|—É–∫–∞—á—É—î|—Ö–≤–æ—Ä–∞|—Ö–≤–æ—Ä–∏–π
ü§£	–∫–∞—á–∞—î—Ç—å—Å—è –≤—ñ–¥ —Å–º—ñ—Ö—É	–≤–µ—Å–µ–ª–∏–π|–¥–æ —Å–ª—ñ–∑|–∫–∞—á–∞—î—Ç—å—Å—è –≤—ñ–¥ —Å–º—ñ—Ö—É|–∫—É–º–µ–¥–Ω–∏–π|–æ–±–ª–∏—á—á—è|—Ä–µ–≥—ñ—Ç|—Å–º—ñ—Ö|—Å–º—ñ—à–Ω–∏–π|—Å–º—ñ—è—Ç–∏—Å—è|—É–º–∏—Ä–∞—Ç–∏ –∑—ñ —Å–º—ñ—Ö—É|—Ö–∞—Ö–∞
ü§§	–æ–±–ª–∏—á—á—è, —â–æ –ø—É—Å–∫–∞—î —Å–ª–∏–Ω—É	–≥–æ–ª–æ–¥–Ω–∏–π|–æ–±–ª–∏—á—á—è|–ø—É—Å–∫–∞—î —Å–ª–∏–Ω—É|—Å–ª–∏–Ω–∞
ü§•	–æ–±–ª–∏—á—á—è, —â–æ –±—Ä–µ—à–µ	–±—Ä–µ—Ö–ª–æ|–±—Ä–µ—Ö–Ω—è|–±—Ä–µ—Ö—É–Ω|–∑–±—Ä–µ—Ö–∞–≤|–Ω–µ–ø—Ä–∞–≤–¥–∞|–æ–±–ª–∏—á—á—è|–æ–±–º–∞–Ω|–ø—ñ–Ω–æ–∫–∫—ñ–æ
ü§¶	–ª—é–¥–∏–Ω–∞ –∑ –¥–æ–ª–æ–Ω–µ—é –¥–æ –æ–±–ª–∏—á—á—è	–±–æ–∂–µ|–æ–±–ª–∏—á—á—è|—Ä–æ–∑–¥—Ä–∞—Ç—É–≤–∞–Ω–Ω—è|—Ä–æ–∑—á–∞—Ä—É–≤–∞–Ω–Ω—è|—Ä—É–∫–∞|—Ä—É–∫–∞–ª–∏—Ü–µ|—Å–∫—ñ–ª—å–∫–∏ –º–æ–∂–Ω–∞|—Å–æ—Ä–æ–º|—Ñ–µ–π—Å–ø–∞–ª–º
ü§ß	–æ–±–ª–∏—á—á—è, —â–æ —á—Ö–∞—î	–∞–ø—á—Ö–∏|–≥—Ä–∏–ø|–∑–∞—Å—Ç—É–¥–∞|–Ω–µ–∂–∏—Ç—å|–æ–±–ª–∏—á—á—è|–æ–±–ª–∏—á—á—è, —â–æ —á—Ö–∞—î|–û–†–ó|—Ö–≤–æ—Ä–æ–±–∞|—á—Ö–∞–Ω–Ω—è|—â–æ —á—Ö–∞—î
ü§®	–æ–±–ª–∏—á—á—è –∑ –ø—ñ–¥–Ω—è—Ç–∏–º–∏ –±—Ä–æ–≤–∞–º–∏	–±—Ä–æ–≤–∏|–≥–º|–∫–æ–Ω—Ñ—É–∑|–Ω–µ –≤—ñ—Ä—é|–Ω–µ —Ä–æ–∑—É–º—ñ—é|–Ω–µ–¥–æ–≤—ñ—Ä–∞|–æ–±–ª–∏—á—á—è|–æ—Ç–∞–∫–æ—ó|—Å–∫–µ–ø—Ç–∏—á–Ω–∏–π|—Å–ø—Ä–∞–≤–¥—ñ|—â–æ
ü§©	–æ—á—ñ-–∑—ñ—Ä–æ—á–∫–∏	–≤–µ—Å–µ–ª–∏–π|–≤–∏–≥—Ä–∞—à|–∑—ñ—Ä–∫–∞|–æ–±–ª–∏—á—á—è|–æ—á—ñ|–ø–æ—Å–º—ñ—à–∫–∞|—Ä–∞–¥—ñ—Å—Ç—å|—É—Å–º—ñ—à–∫–∞|—â–∞—Å—Ç—è
ü§™	–±–æ–∂–µ–≤—ñ–ª—å–Ω–µ –æ–±–ª–∏—á—á—è	–±–æ–∂–µ–≤—ñ–ª—å–Ω–µ –æ–±–ª–∏—á—á—è|–±–æ–∂–µ–≤—ñ–ª—å–Ω–∏–π|–≤–µ–ª–∏–∫–∏–π|–º–∞–ª–∏–π|–æ–∫–æ|—Å–∫–∞–∂–µ–Ω–∏–π
ü§´	–æ–±–ª–∏—á—á—è, —â–æ —Ü–∏–∫–∞—î	–∑–∞–º–æ–≤–∫–Ω—ñ—Ç—å|–º–æ–≤—á—ñ—Ç—å|–Ω–µ –≥–æ–º–æ–Ω—ñ—Ç—å|–æ–±–ª–∏—á—á—è|–ø–æ—à–µ–ø–∫–∏|—Ç–∏—Ö—ñ—à–µ|—Ç–∏—Ö–æ|—Ç–∏—à–∞|—Ç—Å—Å—Å|—à–µ–ø—ñ—Ç
ü§¨	–æ–±–ª–∏—á—á—è —ñ–∑ —Å–∏–º–≤–æ–ª–∞–º–∏ –≤ —Ä–æ—Ç—ñ	–≥–Ω—ñ–≤|–ª–∞–π–∫–∞|–ª–∞—è—Ç–∏—Å—è|–º–∞—Ç—é–∫|–Ω–µ —Å–∫–∞–∂—É|–æ–±–ª–∏—á—á—è|—Å–µ—Ä–¥–∏—Ç–∏–π|—Å—É–≤–æ—Ä–∏–π|—Ü–µ–Ω–∑—É—Ä–∞
ü§≠	–æ–±–ª–∏—á—á—è, —â–æ –ø—Ä–∏–∫—Ä–∏–≤–∞—î —Ä–æ—Ç–∞ —Ä—É–∫–æ—é	–º–æ–≤—á—É|–æ–±–ª–∏—á—á—è|–æ–π|—Å–µ–∫—Ä–µ—Ç|—Å–º—ñ—à–Ω–æ|—Å—é—Ä–ø—Ä–∏–∑|—Ç–∞–π–Ω–∞|—Ç–∏—Ö–æ|—É–ø—Å|—Ö–∏—Ö–∏–∫–∞–Ω–Ω—è
ü§Æ	–æ–±–ª–∏—á—á—è, —â–æ –±–ª—é—î	–±–ª—é–≤–∞–Ω–Ω—è|–±–ª—é–≤–æ—Ç–∞|–º–µ–Ω—ñ –ø–æ–≥–∞–Ω–æ|–Ω—É–¥–∏—Ç—å|–Ω—É–¥–æ—Ç–∞|–æ–±–ª–∏—á—á—è|–æ—Ç—Ä—É—ó–≤—Å—è
ü§Ø	–≥–æ–ª–æ–≤–∞, —â–æ –≤–∏–±—É—Ö–∞—î	–≤–∏–Ω–æ—Å –º–æ–∑–∫—É|–≥–æ–ª–æ–≤–∞|–≥–æ–ª–æ–≤–∞, —â–æ –≤–∏–±—É—Ö–∞—î|–Ω–µ –º–æ–∂–µ –±—É—Ç–∏|–Ω–µ–π–º–æ–≤—ñ—Ä–Ω–æ|—à–æ–∫|—à–æ–∫–æ–≤–∞–Ω–∏–π|—â–æ –≤–∏–±—É—Ö–∞—î
ü§∞	–≤–∞–≥—ñ—Ç–Ω–∞ –∂—ñ–Ω–∫–∞	–≤–∞–≥—ñ—Ç–Ω–∞|–≤–∞–≥—ñ—Ç–Ω—ñ—Å—Ç—å|–∂—ñ–Ω–∫–∞
ü§±	–≥—Ä—É–¥–Ω–µ –≤–∏–≥–æ–¥–æ–≤—É–≤–∞–Ω–Ω—è	–≥–æ–¥—É–≤–∞–Ω–Ω—è|–≥—Ä—É–¥–∏|–≥—Ä—É–¥–Ω–µ –≤–∏–≥–æ–¥–æ–≤—É–≤–∞–Ω–Ω—è|–º–∞—Ç–µ—Ä–∏–Ω—Å—Ç–≤–æ|–º–æ–ª–æ–∫–æ –º–∞—Ç–µ—Ä—ñ|–Ω–µ–º–æ–≤–ª—è|–Ω–æ–≤–æ–Ω–∞—Ä–æ–¥–∂–µ–Ω–∞|–Ω–æ–≤–æ–Ω–∞—Ä–æ–¥–∂–µ–Ω–∏–π|—Ç—É—Ä–±–æ—Ç–∞
ü§≤	–¥–æ–ª–æ–Ω—ñ, –ø—ñ–¥–Ω—è—Ç—ñ —Ä–∞–∑–æ–º	–±–∞–∂–∞–Ω–Ω—è|–¥–æ–ª–æ–Ω—ñ|–¥–æ–ª–æ–Ω—ñ, –ø—ñ–¥–Ω—è—Ç—ñ —Ä–∞–∑–æ–º|–º–æ–ª–∏—Ç–≤–∞|–º–æ–ª–∏—Ç–∏—Å—è|–ø—ñ–¥–Ω—è—Ç—ñ —Ä–∞–∑–æ–º
ü§≥	—Å–µ–ª—Ñ—ñ	–∞–≤—Ç–æ–ø–æ—Ä—Ç—Ä–µ—Ç|–∫–∞–º–µ—Ä–∞|—Å–µ–ª—Ñ—ñ|—Ç–µ–ª–µ—Ñ–æ–Ω|—Ñ–æ—Ç–æ
ü§¥	–ø—Ä–∏–Ω—Ü	–∫–æ—Ä–æ–ª–µ–≤–∏—á|–∫–æ—Ä–æ–ª—ñ–≤—Å—Ç–≤–æ|–∫–æ—Ä–æ–Ω–∞|–ø—Ä–∏–Ω—Ü|—Ä–æ–±–æ—Ç–∞
ü§µ	–ª—é–¥–∏–Ω–∞ –≤ —Å–º–æ–∫—ñ–Ω–≥—É	–≤–µ—á–µ—Ä—è|–ª—é–¥–∏–Ω–∞|–ª—é–¥–∏–Ω–∞ –≤ —Å–º–æ–∫—ñ–Ω–≥—É|–Ω–∞—Ä–µ—á–µ–Ω–∏–π|–æ—Ñ—ñ—Ü—ñ–∞–Ω—Ç|–ø—Ä–∏–π–æ–º|—Å–º–æ–∫—ñ–Ω–≥|—á–æ–ª–æ–≤—ñ–∫|—á–æ–ª–æ–≤—ñ–∫ —É —Å–º–æ–∫—ñ–Ω–≥—É
ü§∂	–ü–∞–Ω—ñ –ö–ª–∞—É—Å	–∂—ñ–Ω–∫–∞|–∂—ñ–Ω–∫–∞ —Å–∞–Ω—Ç–∞-–∫–ª–∞—É—Å–∞|–∑–∏–º–∞|–ù–æ–≤–∏–π —Ä—ñ–∫|–ü–∞–Ω—ñ –ö–ª–∞—É—Å|—Ä—ñ–∑–¥–≤–æ|–†—ñ–∑–¥–≤–æ|—Å–≤—è—Ç–∞
ü§∑	–ª—é–¥–∏–Ω–∞, —â–æ –∑–Ω–∏–∑—É—î –ø–ª–µ—á–∏–º–∞	–±–∞–π–¥—É–∂–µ|–±–∞–π–¥—É–∂—ñ—Å—Ç—å|–∑–Ω–∏–∑—É–≤–∞–Ω–Ω—è|–º–∞–±—É—Ç—å|–Ω–µ –∑–Ω–∞—é|–Ω–µ–≤—ñ–¥–æ–º–æ|—Ä–æ–∑–≥—É–±–ª–µ–Ω—ñ—Å—Ç—å|—Å—É–º–Ω—ñ–≤|—Ö—Ç–æ–∑–Ω–∞
ü§∏	–ª—é–¥–∏–Ω–∞, —â–æ –ø–µ—Ä–µ–≤–µ—Ä—Ç–∞—î—Ç—å—Å—è ¬´–∫–æ–ª–µ—Å–æ–º¬ª	–∞–∫—Ä–æ–±–∞—Ç|–∞–∫—Ç–∏–≤–Ω–∏–π|–≥—ñ–º–Ω–∞—Å—Ç–∏–∫–∞|–∫–æ–ª–µ—Å–æ|–ª—é–¥–∏–Ω–∞|–ª—é–¥–∏–Ω–∞, —â–æ –ø–µ—Ä–µ–≤–µ—Ä—Ç–∞—î—Ç—å—Å—è ¬´–∫–æ–ª–µ—Å–æ–º¬ª|–ø—ñ–¥–Ω–µ—Å–µ–Ω–∏–π|—Å–ø–æ—Ä—Ç|—â–∞—Å–ª–∏–≤–∏–π|—â–æ –ø–µ—Ä–µ–≤–µ—Ä—Ç–∞—î—Ç—å—Å—è ¬´–∫–æ–ª–µ—Å–æ–º¬ª
ü§π	–ª—é–¥–∏–Ω–∞, —â–æ –∂–æ–Ω–≥–ª—é—î	–±–∞–≥–∞—Ç–æ–∑–∞–¥–∞—á–Ω—ñ—Å—Ç—å|–±–∞–ª–∞–Ω—Å|–≤–ø–æ—Ä–∞—Ç–∏—Å—è|–∂–æ–Ω–≥–ª–µ—Ä|–∂–æ–Ω–≥–ª—é–≤–∞–Ω–Ω—è|–ª—é–¥–∏–Ω–∞|—É–º—ñ–Ω–Ω—è|—Ñ–æ–∫—É—Å|—Ü–∏—Ä–∫
ü§∫	—Ñ–µ—Ö—Ç—É–≤–∞–ª—å–Ω–∏–∫	–∑–º–∞–≥–∞–Ω–Ω—è|—Å–ø–æ—Ä—Ç|—Ñ–µ—Ö—Ç—É–≤–∞–ª—å–Ω–∏–∫|—Ñ–µ—Ö—Ç—É–≤–∞–ª—å–Ω–∏—Ü—è|—Ñ–µ—Ö—Ç—É–≤–∞–Ω–Ω—è|—à–∞–±–ª—è|—à–ø–∞–≥–∞
ü§º	–±–æ—Ä—Ü—ñ	–±—ñ–π|–±–æ—Ä–µ—Ü—å|–±–æ—Ä–æ—Ç—å–±–∞|–±–æ—Ä—Ü—ñ|–¥–≤–æ–±—ñ–π|–¥—É–µ–ª—å|–ª—é–¥–∏–Ω–∞|–ø–æ—î–¥–∏–Ω–æ–∫|—Å–ø–æ—Ä—Ç|—Ç—É—Ä–Ω—ñ—Ä —ñ–∑ –≤—ñ–ª—å–Ω–æ—ó –±–æ—Ä–æ—Ç—å–±–∏
ü§Ω	–ª—é–¥–∏–Ω–∞, —â–æ –≥—Ä–∞—î —É –≤–∞—Ç–µ—Ä–ø–æ–ª–æ	–≤–æ–¥–∞|–≤–æ–¥–Ω–µ –ø–æ–ª–æ|–≤–æ–¥–Ω–∏–π —Å–ø–æ—Ä—Ç|–ª—é–¥–∏–Ω–∞|–ª—é–¥–∏–Ω–∞, —â–æ –≥—Ä–∞—î —É –≤–∞—Ç–µ—Ä–ø–æ–ª–æ|–ø–ª–∞–≤–∞–Ω–Ω—è|–ø–æ–ª–æ|—Å–ø–æ—Ä—Ç|—â–æ –≥—Ä–∞—î —É –≤–∞—Ç–µ—Ä–ø–æ–ª–æ
ü§æ	–ª—é–¥–∏–Ω–∞, —â–æ –≥—Ä–∞—î —É –≥–∞–Ω–¥–±–æ–ª	–≥–∞–Ω–¥–±–æ–ª|–∫–∏–¥–æ–∫|–ª–æ–≤–∏—Ç–∏|–ª—é–¥–∏–Ω–∞|–ª—é–¥–∏–Ω–∞, —â–æ –≥—Ä–∞—î —É –≥–∞–Ω–¥–±–æ–ª|–º‚Äô—è—á|–ø–µ—Ä–µ–∫–∏–¥–∞—Ç–∏ –º º—è—á|–ø–æ–¥–∞—á–∞|—Å–ø–æ—Ä—Ç|—â–æ –≥—Ä–∞—î —É –≥–∞–Ω–¥–±–æ–ª
ü§ø	–º–∞—Å–∫–∞ –∑ —Ç—Ä—É–±–∫–æ—é	–∞–∫–≤–∞–ª–∞–Ω–≥|–¥–∞–π–≤—ñ–Ω–≥|–∑–∞–Ω—É—Ä–µ–Ω–Ω—è|–º–∞—Å–∫–∞ –∑ —Ç—Ä—É–±–∫–æ—é|–º–∞—Å–∫–∞ —ñ –ª–∞—Å—Ç–∏|–º–∞—Å–∫–∞ —ñ —Ç—Ä—É–±–∫–∞|–ø—ñ–¥–≤–æ–¥–Ω–µ –ø–ª–∞–≤–∞–Ω–Ω—è|—Å–Ω–æ—Ä–∫–µ–ª—ñ–Ω–≥
ü•Ä	–ø—Ä–∏–≤ º—è–ª–∞ —Ç—Ä–æ—è–Ω–¥–∞	–∑–∞–≤ º—è–ª–∞ —Ç—Ä–æ—è–Ω–¥–∞|–∑—ñ–≤‚Äô—è–ª–∞|–∑—ñ–≤‚Äô—è–ª–∞ —Ç—Ä–æ—è–Ω–¥–∞|–∫–≤—ñ—Ç–∫–∞|–ø—Ä–∏–≤ º—è–ª–∞ —Ç—Ä–æ—è–Ω–¥–∞
ü•Å	–±–∞—Ä–∞–±–∞–Ω	–±–∞—Ä–∞–±–∞–Ω|–º—É–∑–∏–∫–∞|–ø–∞–ª–∏—á–∫–∏
ü•Ç	–¥–∑–≤—ñ–Ω –±–æ–∫–∞–ª—ñ–≤	–±–æ–∫–∞–ª—ñ–≤|–±—É–¥—å–º–æ|–¥–∑–≤—ñ–Ω|–Ω–∞–ø—ñ–π|–ù–æ–≤–∏–π —Ä—ñ–∫|—Å–≤—è—Ç–∫—É–≤–∞–Ω–Ω—è
ü•É	–±–æ–∫–∞–ª –≤—ñ—Å–∫—ñ	–∞–ª–∫–æ–≥–æ–ª—å|–±–æ–∫–∞–ª|–≤—ñ—Å–∫—ñ|–Ω–∞–ø—ñ–π|—Å–ø–∏—Ä—Ç–Ω–µ|—Å—Ç–∞–∫–∞–Ω –≤—ñ—Å–∫—ñ
ü•Ñ	–ª–æ–∂–∫–∞	–ª–æ–∂–∫–∞|–ø—Ä–∏–±–æ—Ä–∏|—Å—Ç–æ–ª–æ–≤—ñ –ø—Ä–∏–±–æ—Ä–∏
ü•Ö	—Å—ñ—Ç–∫–∞ –≤–æ—Ä—ñ—Ç	–≤–æ—Ä–æ—Ç–∞|—Å—ñ—Ç–∫–∞|—Å—ñ—Ç–∫–∞ –≤–æ—Ä—ñ—Ç|—Å–ø–æ—Ä—Ç
ü•á	–∑–æ–ª–æ—Ç–∞ –º–µ–¥–∞–ª—å	–∑–æ–ª–æ—Ç–∞ –º–µ–¥–∞–ª—å|–∑–æ–ª–æ—Ç–æ|–º–µ–¥–∞–ª—å|–º—ñ—Å—Ü–µ|–ø–µ—Ä—à–µ
ü•à	—Å—Ä—ñ–±–Ω–∞ –º–µ–¥–∞–ª—å	–¥—Ä—É–≥–µ|–º–µ–¥–∞–ª—å|–º—ñ—Å—Ü–µ|—Å—Ä—ñ–±–ª–æ|—Å—Ä—ñ–±–Ω–∞ –º–µ–¥–∞–ª—å
ü•â	–±—Ä–æ–Ω–∑–æ–≤–∞ –º–µ–¥–∞–ª—å	–±—Ä–æ–Ω–∑–∞|–±—Ä–æ–Ω–∑–æ–≤–∞ –º–µ–¥–∞–ª—å|–º–µ–¥–∞–ª—å|–º—ñ—Å—Ü–µ|—Å–ø–æ—Ä—Ç|—Ç—Ä–µ—Ç—î
ü•ä	–±–æ–∫—Å–µ—Ä—Å—å–∫–∞ —Ä—É–∫–∞–≤–∏—á–∫–∞	–±–æ–∫—Å|–±–æ–∫—Å–µ—Ä—Å—å–∫–∞ —Ä—É–∫–∞–≤–∏—á–∫–∞|–Ω–æ–∫–∞—É—Ç|–Ω–æ–∫–¥–∞—É–Ω|—Ä—É–∫–∞–≤–∏—á–∫–∞|—Å–ø–æ—Ä—Ç
ü•ã	–æ–¥—è–≥ –¥–ª—è —î–¥–∏–Ω–æ–±–æ—Ä—Å—Ç–≤	–±–æ–π–æ–≤—ñ –º–∏—Å—Ç–µ—Ü—Ç–≤–∞|–¥–∑—é–¥–æ|–∫–∞—Ä–∞—Ç–µ|–∫—ñ–º–æ–Ω–æ|–æ–¥—è–≥ –¥–ª—è —î–¥–∏–Ω–æ–±–æ—Ä—Å—Ç–≤|—Ç—Ö–µ–∫–≤–æ–Ω–¥–æ|—É–Ω—ñ—Ñ–æ—Ä–º–∞|—Ñ–æ—Ä–º–∞|—á–æ—Ä–Ω–∏–π –ø–æ—è—Å
ü•å	–∫–∞–º º—è–Ω–∞ —à–∞–π–±–∞ –¥–ª—è –∫–µ—Ä–ª—ñ–Ω–≥—É	–≥—Ä–∞|–∫–∞–º º—è–Ω–∞ —à–∞–π–±–∞ –¥–ª—è –∫–µ—Ä–ª—ñ–Ω–≥—É|–∫–∞–º—ñ–Ω—å|–∫–∞–º—ñ–Ω—å –¥–ª—è –∫–µ—Ä–ª—ñ–Ω–≥–∞|–∫–µ—Ä–ª—ñ–Ω–≥|—Å–ø–æ—Ä—Ç
ü•ç	—Å—Ç—ñ–∫ –¥–ª—è –ª–∞–∫—Ä–æ—Å—É	–≥–æ–ª|–ª–∞–∫—Ä–æ—Å|–º‚Äô—è—á|–ø–∞–ª–∏—Ü—è|—Ä–∞–∫–µ—Ç–∫–∞|—Å–ø–æ—Ä—Ç|—Å—Ç—ñ–∫|—Å—Ç—ñ–∫ –¥–ª—è –ª–∞–∫—Ä–æ—Å—É
ü•é	—Å–æ—Ñ—Ç–±–æ–ª—å–Ω–∏–π –º º—è—á	–±–µ–π—Å–±–æ–ª|–±–∏—Ç–∫–∞|–º‚Äô—è—á|—Ä—É–∫–∞–≤–∏—Ü—è|—Ä—É–∫–∞–≤–∏—á–∫–∞|—Å–æ—Ñ—Ç|—Å–æ—Ñ—Ç–±–æ–ª|—Å–æ—Ñ—Ç–±–æ–ª—å–Ω–∏–π –º º—è—á|—Å–ø–æ—Ä—Ç
ü•è	–ª—ñ—Ç–∞—é—á–∏–π –¥–∏—Å–∫	–∞–ª—Ç–∏–º–∞—Ç|–¥–∏—Å–∫|–∫–∏–¥–æ–∫|–ª–µ—Ç—é—á–∏–π –¥–∏—Å–∫|–ª—ñ—Ç–∞—é—á–∏–π –¥–∏—Å–∫|—Ç–∞—Ä—ñ–ª–∫–∞|—Ñ—Ä–∏–∑–±—ñ|—Ñ—Ä—ñ–∑–±—ñ
ü•ê	–∫—Ä—É–∞—Å–∞–Ω	–±—É–ª–æ—á–Ω–∏–π –≤–∏—Ä—ñ–±|–∑–≤—ñ–π –ø—ñ–≤–º—ñ—Å—è—Ü–µ–º|—ó–∂–∞|–∫—Ä—É–∞—Å–∞–Ω|–ø–µ–∫–∞—Ä–Ω—è|—Å–Ω—ñ–¥–∞–Ω–æ–∫|–§—Ä–∞–Ω—Ü—ñ—è|—Ñ—Ä–∞–Ω—Ü—É–∑—å–∫–∏–π
ü•ë	–∞–≤–æ–∫–∞–¥–æ	–∞–≤–æ–∫–∞–¥–æ|—ó–∂–∞|–ø–ª—ñ–¥
ü•í	–æ–≥—ñ—Ä–æ–∫	—ó–∂–∞|–∫–æ—Ä–Ω—ñ—à–æ–Ω|–æ–≤–æ—á|–æ–≥—ñ—Ä–æ–∫
ü•ì	–±–µ–∫–æ–Ω	–±–µ–∫–æ–Ω|—ó–∂–∞|–º‚Äô—è—Å–æ
ü•î	–∫–∞—Ä—Ç–æ–ø–ª—è	—ó–∂–∞|–∫–∞—Ä—Ç–æ–ø–ª—è|–æ–≤–æ—á
ü•ï	–º–æ—Ä–∫–≤–∞	–∑–∞—è—Ü—å|–∑–∞—è—á–∞ —ó–∂–∞|—ó–∂–∞|–º–æ—Ä–∫–≤–∞|–º–æ—Ä–∫–≤–∏–Ω–∞|–æ–≤–æ—á
ü•ñ	–±–∞–≥–µ—Ç	–±–∞–≥–µ—Ç|–±—É–ª–∫–∞|–≤–∏–ø—ñ—á–∫–∞|—ó–∂–∞|—Ñ—Ä–∞–Ω—Ü—ñ—è|—Ñ—Ä–∞–Ω—Ü—É–∑—å–∫–∏–π|—Ö–ª—ñ–±
ü•ó	–∑–µ–ª–µ–Ω–∏–π —Å–∞–ª–∞—Ç	–¥—ñ—î—Ç–∞|–∑–¥–æ—Ä–æ–≤–µ —Ö–∞—Ä—á—É–≤–∞–Ω–Ω—è|–∑–µ–ª–µ–Ω–∏–π|—ó–∂–∞|—Å–∞–ª–∞—Ç
ü•ò	–∫–∞—Å—Ç—Ä—É–ª—è –∑ —ó–∂–µ—é	—ó–∂–∞|–∫–∞—Å—Ç—Ä—É–ª—è|–∫–∞—Å—Ç—Ä—É–ª—è –∑ —ó–∂–µ—é|–ø–ª–æ–≤|—Ä–∞–≥—É|—Å—É–ø
ü•ô	–ø—ñ—Ç–∞	—ó–∂–∞|–∫–µ–±–∞–±|–ª–∞–≤–∞—à|–ª–∞–≤–∞—à —ñ–∑ –Ω–∞—á–∏–Ω–∫–æ—é|–Ω–∞—á–∏–Ω–∫–∞|–ø—ñ—Ç–∞|—Ñ–∞–ª–∞—Ñ–µ–ª—å
ü•ö	—è–π—Ü–µ	–í–µ–ª–∏–∫–¥–µ–Ω—å|—ó–∂–∞|—è–π—Ü–µ
ü•õ	—Å–∫–ª—è–Ω–∫–∞ –º–æ–ª–æ–∫–∞	–º–æ–ª–æ–∫–æ|–Ω–∞–ø—ñ–π|—Å–∫–ª—è–Ω–∫–∞|—Å–∫–ª—è–Ω–∫–∞ –º–æ–ª–æ–∫–∞
ü•ú	–∞—Ä–∞—Ö—ñ—Å	–∞—Ä–∞—Ö—ñ—Å|–≥–æ—Ä—ñ—Ö|–∑–µ–º–ª—è–Ω–∏–π –≥–æ—Ä—ñ—Ö|—ó–∂–∞|—ó—Å—Ç—ñ–≤–Ω–∏–π
ü•ù	–∫—ñ–≤—ñ	—ó–∂–∞|–∫—ñ–≤—ñ|–ø–ª—ñ–¥|—Ñ—Ä—É–∫—Ç
ü•û	–º–ª–∏–Ω—Ü—ñ	—ó–∂–∞|–∫—Ä–µ–ø|–∫—Ä–µ–ø–∏|–º–ª–∏–Ω–µ—Ü—å|–º–ª–∏–Ω—Ü—ñ|–Ω–∞–ª–∏—Å–Ω–∏–∫|–Ω–∞–ª–∏—Å–Ω–∏–∫–∏|—Å–Ω—ñ–¥–∞–Ω–æ–∫
ü•ü	–≤–∞—Ä–µ–Ω–∏–∫	–≤–∞—Ä–µ–Ω–∏–∫|–≤—É—à–∫–æ|–≥–∞–ª—É—à–∫–∞|—ó–∂–∞|–ø–µ–ª—å–º–µ–Ω—å|–ø–∏—Ä—ñ–∂–æ–∫|–ø–∏—Ä–æ–≥–∏
ü•†	–ø–µ—á–∏–≤–æ –∑ –ø–µ—Ä–µ–¥–±–∞—á–µ–Ω–Ω—è–º	–ø–µ—á–∏–≤–æ –∑ –ø–µ—Ä–µ–¥–±–∞—á–µ–Ω–Ω—è–º|–ø–µ—á–∏–≤–æ –∑ –ø–æ–≤—ñ–¥–æ–º–ª–µ–Ω–Ω—è–º|–ø–µ—á–∏–≤–æ-–ø—Ä–æ—Ä–æ—Ü—Ç–≤–æ|–ø—Ä–æ—Ä–æ—Ü—Ç–≤–æ
ü•°	–∫–æ—Ä–æ–±–∫–∞ –∑ —ó–∂–µ—é –Ω–∞ –≤–∏–Ω–æ—Å	–¥–æ—Å—Ç–∞–≤–∫–∞ —ó–∂—ñ|—ó–∂–∞|–∫–æ—Ä–æ–±–∫–∞ –∑ —ó–∂–µ—é –Ω–∞ –≤–∏–Ω–æ—Å|–∫–æ—Ä–æ–±–∫–∞ –∑ –∫–∏—Ç–∞–π—Å—å–∫–æ—é —ó–∂–µ—é|–ø–∞–ª–∏—á–∫–∏ –¥–ª—è —ó–∂—ñ
ü•¢	–ø–∞–ª–∏—á–∫–∏ –¥–ª—è —ó–∂—ñ	–∫—É–∞–π—Ü–∑–∏|–æ-—Ö–∞—Å—ñ|–ø–∞–ª–∏—á–∫–∏|–ø–∞–ª–∏—á–∫–∏ –¥–ª—è —ó–∂—ñ|—Ö–∞—à—ñ|—á–æ–∫–∫–∞—Ä–∞–∫
ü•£	–º–∏—Å–∫–∞ –∑ –ª–æ–∂–∫–æ—é	–±–æ—Ä—â|–∑–ª–∞–∫–∏|—ó–∂–∞|–º–∏—Å–∫–∞ –∑ –ª–æ–∂–∫–æ—é|–ø—ñ–∞–ª–∞|—Ä–∏—Å–æ–≤–∞ –∫–∞—à–∞|—Å–Ω—ñ–¥–∞–Ω–æ–∫|—Å—É–ø
ü•§	—Å—Ç–∞–∫–∞–Ω —ñ–∑ —Å–æ–ª–æ–º–∏–Ω–∫–æ—é	–Ω–∞–ø—ñ–π|–æ–¥–Ω–æ—Ä–∞–∑–æ–≤–∏–π —Å—Ç–∞–∫–∞–Ω|—Å—ñ–∫|—Å–æ–¥–æ–≤–∞|—Å–æ–ª–æ–º–∏–Ω–∫–∞|—Å–æ–ª–æ–º–∫–∞|—Ç—Ä—É–±–æ—á–∫–∞
ü••	–∫–æ–∫–æ—Å	–≤—ñ–¥–ø—É—Å—Ç–∫–∞|–∫–æ–∫–æ—Å|–ø–∞–ª—å–º–∞|–ü—ñ–Ω–∞-–ö–æ–ª–∞–¥–∞|–ø—ñ–Ω—å—è –∫–æ–ª–∞–¥–∞|—Ç—Ä–æ–ø—ñ–∫–∏
ü•¶	–±—Ä–æ–∫–æ–ª—ñ	–±—Ä–æ–∫–æ–ª—ñ|—ó–∂–∞|–∫—É—á–µ—Ä—è–≤–∞|–æ–≤–æ—á|—Ü–≤—ñ—Ç–Ω–∞ –∫–∞–ø—É—Å—Ç–∞
ü•ß	–ø–∏—Ä—ñ–≥	–≤–∏–ø—ñ—á–∫–∞|–¥–µ—Å–µ—Ä—Ç|–Ω–∞—á–∏–Ω–∫–∞|–ø–∏—Ä—ñ–≥
ü•®	–∫—Ä–µ–Ω–¥–µ–ª—å	–±—É–±–ª–∏–∫|–≤–∏–ø—ñ—á–∫–∞|–∫—Ä–µ–Ω–¥–µ–ª–∏–∫|–∫—Ä–µ–Ω–¥–µ–ª—å|–ø—Ä–µ—Ü–µ–ª—å|—Å–ø–ª–µ—Ç–µ–Ω–∏–π
ü•©	–º º—è—Å–Ω–∏–π —Ñ—ñ–ª–µ–π	–±–∞—Ä–∞–Ω—è—á–∞ –≤—ñ–¥–±–∏–≤–Ω–∞|—ó–∂–∞|–∫–æ—Ç–ª–µ—Ç–∞|–º º—è—Å–Ω–∏–π —Ñ—ñ–ª–µ–π|–º º—è—Å–æ|—Å–≤–∏–Ω—è—á–∞ –∫–æ—Ç–ª–µ—Ç–∞|—Å—Ç–µ–π–∫
ü•™	—Å–∞–Ω–¥–≤—ñ—á	—ó–∂–∞|—Å–∞–Ω–¥–≤—ñ—á|—Å–µ–Ω–¥–≤—ñ—á|—Ö–ª—ñ–±
ü•´	–∫–æ–Ω—Å–µ—Ä–≤–∏	–±–∞–Ω–∫–∞|–∫–æ–Ω—Å–µ—Ä–≤–∏|–∫–æ–Ω—Å–µ—Ä–≤–æ–≤–∞–Ω—ñ —Ç–æ–º–∞—Ç–∏
ü•¨	–ª–∏—Å—Ç—è —Å–∞–ª–∞—Ç—É	–±–æ–∫-—á–æ–π|–±—É—Ä“ë–µ—Ä–∏|–∑–µ–ª–µ–Ω—ñ –ª–∏—Å—Ç–∫–∏|–∑–µ–ª–µ–Ω—å|–∫–∞–ø—É—Å—Ç–∞|–∫–µ–ª—å|–ª–∞—Ç—É–∫|–ª–∏—Å—Ç–æ–∫|–ª–∏—Å—Ç—è|–ª–∏—Å—Ç—è —Å–∞–ª–∞—Ç—É|—Å–∞–ª–∞—Ç
ü•≠	–º–∞–Ω–≥–æ	—ó–∂–∞|–º–∞–Ω–≥–æ|–ø–ª—ñ–¥|—Ç—Ä–æ–ø—ñ—á–Ω–∏–π|—Ñ—Ä—É–∫—Ç|—à–µ–π–∫–µ—Ä
ü•Æ	–º—É–Ω–∫–µ–π–∫	–ê–∑—ñ—è|–º—ñ—Å—è—á–Ω–∏–π –ø–∏—Ä—ñ–≥|–º—ñ—Å—è—á–Ω–∏–π –ø—Ä—è–Ω–∏–∫|–º—É–Ω–∫–µ–π–∫|–æ—Å—ñ–Ω—å|–ø–∏—Ä—ñ–∂–æ–∫|–ø–æ–≤–Ω–∏–π –º—ñ—Å—è—Ü—å|—Å–≤—è—Ç–æ|—Ñ–µ—Å—Ç–∏–≤–∞–ª—å|—é–µ–±—ñ–Ω
ü•Ø	–±–µ–π–≥–ª	–±–∞–≥–µ–ª—å|–±–µ–π–≥–ª|–±—É–±–ª–∏–∫|–±—É–ª–æ—á–∫–∞|–≤–∏–ø—ñ—á–∫–∞|–¥–µ—Å–µ—Ä—Ç|–Ω–∞—á–∏–Ω–∫–∞|–ø–∞–º–ø—É—Ö|–ø–æ–Ω—á–∏–∫|—Å–Ω—ñ–¥–∞–Ω–æ–∫
ü•∞	—É—Å–º—ñ—Ö–Ω–µ–Ω–µ –æ–±–ª–∏—á—á—è —ñ–∑ —Å–µ—Ä–¥–µ—á–∫–∞–º–∏	–∑–∞–∫–æ—Ö–∞–Ω—ñ—Å—Ç—å|–∫–æ—Ö–∞–Ω–Ω—è|–ª—é–±–æ–≤|–Ω—ñ–∂–Ω—ñ—Å—Ç—å|–æ–±–ª–∏—á—á—è|—Å–µ—Ä–¥–µ—á–∫–∞|—Å–µ—Ä—Ü—è|—Å–∏–º–ø–∞—Ç—ñ—è|—É—Å–º—ñ—à–∫–∞|—è –∫–æ—Ö–∞—é —Ç–µ–±–µ
ü•±	–æ–±–ª–∏—á—á—è, —â–æ –ø–æ–∑—ñ—Ö–∞—î	–¥–æ–±—Ä–∞–Ω—ñ—á|–∑–∞—Å–ø–∞–Ω–∏–π|–∑–Ω—É–¥–∂–µ–Ω–∏–π|–Ω—ñ—á|–æ–±–ª–∏—á—á—è|–æ–±–ª–∏—á—á—è, —â–æ –ø–æ–∑—ñ—Ö–∞—î|–ø–æ–∑—ñ—Ö–∞—î|–ø–æ–∑—ñ—Ö–∞–π–ª–æ|–ø–æ–∑—ñ—Ö–∞—Ç–∏|—Å–æ–Ω|—Å—Ç–æ–º–ª–µ–Ω–∏–π|—Ö–æ—á–µ —Å–ø–∞—Ç–∏|—â–æ –ø–æ–∑—ñ—Ö–∞—î
ü•≤	—É—Å–º—ñ—à–∫–∞ –≤ —Å–ª—å–æ–∑–∞—Ö	–≤–¥—è—á–Ω—ñ—Å—Ç—å|–≥–æ—Ä–¥—ñ—Å—Ç—å|–∑–≤–æ—Ä—É—à–µ–Ω–Ω—è|–ø–ª–∞—á|–ø–æ–ª–µ–≥—à–µ–Ω–Ω—è|–ø–æ—Å–º—ñ—à–∫–∞|—Ä–æ–∑—á—É–ª–µ–Ω–∏–π|—Å–ª—å–æ–∑–∞|—Å–º–∞–π–ª|—É—Å–º—ñ—à–∫–∞
ü•≥	—Å–≤—è—Ç–∫–æ–≤–µ –æ–±–ª–∏—á—á—è	–≤–µ—á—ñ—Ä–∫–∞|–≤—ñ—Ç–∞–Ω–Ω—è|–¥–µ–Ω—å –Ω–∞—Ä–æ–¥–∂–µ–Ω–Ω—è|–¥—É–¥–∫–∞|–∑–±—É–¥–∂–µ–Ω–∏–π|–∫–∞–ø–µ–ª—é—Ö|–∫–æ–≤–ø–∞–∫|–æ–±–ª–∏—á—á—è|—Ä–∞–¥—ñ—Å—Ç—å|—Ä—ñ–∂–æ–∫|—Å–≤—è—Ç–∫–æ–≤–µ –æ–±–ª–∏—á—á—è|—Å–≤—è—Ç–∫—É–≤–∞–Ω–Ω—è|—Å–≤—è—Ç–æ|—Å—Ö–≤–∏–ª—å–æ–≤–∞–Ω–∏–π|—Ç—Ä—É–±–æ—á–∫–∞
ü•¥	–æ—á–º–∞–Ω—ñ–ª–µ –æ–±–ª–∏—á—á—è	–¥—É—Ä–º–∞–Ω|–∑–∞–ø–∞–º–æ—Ä–æ—á–µ–Ω–Ω—è|–∑–∞—Ö–º–µ–ª—ñ–ª–∏–π|—ñ–Ω—Ç–æ–∫—Å–∏–∫–∞—Ü—ñ—è|–∫–∞–π—Ñ|–∫–æ—Å—ñ –æ—á—ñ|–æ–¥—É—Ä–º–∞–Ω–µ–Ω–∏–π|–æ—á—ñ —Ä–æ–∑–±—ñ–≥–∞—é—Ç—å—Å—è|–æ—á–º–∞–Ω—ñ–ª–µ –æ–±–ª–∏—á—á—è|–ø‚Äô—è–Ω–∏–π|—è–∑–∏–∫ –∑–∞–ø–ª—ñ—Ç–∞—î—Ç—å—Å—è
ü•µ	—Ä–æ–∑–ø–∞—à—ñ–ª–µ –æ–±–ª–∏—á—á—è	–≤–∏—Å–æ–ª–æ–ø–ª–µ–Ω–∏–π —è–∑–∏–∫|–≥–∞—Ä—è—á–µ|–≥–∞—Ä—è—á–∏–π|–≥–∞—Ä—è—á–∫–∞|–∂–∞—Ä|–∑–∞–¥—É—Ö–∞|–æ–±–ª–∏—á—á—è|–ø–∞–ª–∞—Ç–∏|–ø—ñ—Ç|–ø–æ–º–∏—Ä–∞—î|—Ä–æ–∑–ø–∞—à—ñ–ª–µ –æ–±–ª–∏—á—á—è|—Å–æ–Ω—è—á–Ω–∏–π —É–¥–∞—Ä|—Å–ø–µ–∫–∞|—Ç–µ–ø–ª–æ–≤–∏–π —É–¥–∞—Ä|—á–µ—Ä–≤–æ–Ω–µ –ª–∏—Ü–µ|—á–µ—Ä–≤–æ–Ω–æ—â–æ–∫–∏–π
ü•∂	–∑–∞–º–µ—Ä–∑–ª–µ –æ–±–ª–∏—á—á—è	–±—É—Ä—É–ª—å–∫–∞|–∑–∞–º–µ—Ä–∑–ª–µ –æ–±–ª–∏—á—á—è|–∑–∞–º–µ—Ä–∑–ª–∏–π|–∑—É–± –Ω–∞ –∑—É–±|–º–æ—Ä–æ–∑|–æ–±–º–æ—Ä–æ–∂–µ–Ω–Ω—è|–ø–æ—Å–∏–Ω—ñ–ª–∏–π –≤—ñ–¥ —Ö–æ–ª–æ–¥—É|—Å–∏–Ω—î –ª–∏—Ü–µ|—Å–∏–Ω—î –æ–±–ª–∏—á—á—è|—Ö–æ–ª–æ–¥|—Ü–æ–∫–æ—Ç–∏—Ç—å –∑—É–±–∞–º–∏
ü•∑	–Ω—ñ–Ω–¥–∑—è	–±–æ—î—Ü—å|–≤–±–∏–≤—Ü—è|–≤–æ—ó–Ω|–∫—Ä–∞–¥—å–∫–æ–º–∞|–ª—é–¥–∏–Ω–∞|–º–∞—Å–∫–∞|–Ω–∞–π–º–∞–Ω–µ—Ü—å|–Ω–µ–≤–∏–¥–∏–º–∫–∞|–ø–æ–∫—Ä–∞–¥—å–∫–∏|–ø–æ—Ç–∞–π–∫–∏
ü•∏	–∑–∞–º–∞—Å–∫–æ–≤–∞–Ω–µ –æ–±–ª–∏—á—á—è	–≤—É—Å–∞|–≤—É—Å–∞–Ω—å|–∑–∞–º–∞—Å–∫–æ–≤–∞–Ω–µ –æ–±–ª–∏—á—á—è|—ñ–Ω–∫–æ–≥–Ω—ñ—Ç–æ|–∫–∞–º—É—Ñ–ª—è–∂|–ª—é–¥–∏–Ω–∞|–º–∞—Å–∫–∞|–Ω–∞–∫–ª–∞–¥–Ω–∏–π –Ω—ñ—Å|–Ω–∞–∫–ª–∞–¥–Ω—ñ –≤—É—Å–∞|–Ω—ñ—Å|–æ–±–ª–∏—á—á—è|–æ–∫—É–ª—è—Ä–∏|—à–ø–∏–≥—É–Ω
ü•π	–æ–±–ª–∏—á—á—è, —â–æ –ª–µ–¥–≤–µ —Å—Ç—Ä–∏–º—É—î —Å–ª—å–æ–∑–∏	–±—É–¥—å –ª–∞—Å–∫–∞|–≤–¥—è—á–Ω—ñ—Å—Ç—å|–≥–æ—Ä–¥—ñ—Å—Ç—å|–º–∏–ª–æ|–æ–±–ª–∏—á—á—è|–ø–∏—à–∞—é—Å—è|–ø–ª–∞—á|—Ä–∞–¥–æ—Å—Ç—ñ|—Å–ª—å–æ–∑–∏|—Å—É–º|—Å—Ö–≤–∏–ª—å–æ–≤–∞–Ω–∏–π|—â–∞—Å—Ç—è
ü•∫	–±–ª–∞–≥–∞–ª—å–Ω–µ –æ–±–ª–∏—á—á—è	–±–ª–∞–≥–∞–Ω–Ω—è|–±—É–¥—å –ª–∞—Å–∫–∞|–≤–µ–ª–∏–∫—ñ|–≤–∏–ø—Ä–æ—à—É–≤–∞—Ç–∏|–∂–∞–ª—ñ–±–Ω–µ|–∂–∞–ª—ñ—Å–ª–∏–≤–µ|–º–æ–ª–∏—Ç–∏|–æ–±–ª–∏—á—á—è|–æ—á—ñ|–ø—Ä–æ—Å–∏—Ç–∏|–ø—Ä–æ—Ö–∞–Ω–Ω—è|—Å—É–º–Ω–æ|—â–µ–Ω—è—á—ñ –æ—á—ñ
ü•ª	—Å–∞—Ä—ñ	–≤–±—Ä–∞–Ω–Ω—è|–æ–¥—è–≥|—Å–∞—Ä—ñ
ü•º	–ª–∞–±–æ—Ä–∞—Ç–æ—Ä–Ω–∏–π —Ö–∞–ª–∞—Ç	–±—ñ–ª–∏–π —Ö–∞–ª–∞—Ç|–≤—á–µ–Ω–∏–π|–¥–æ–∫—Ç–æ—Ä|–µ–∫—Å–ø–µ—Ä–∏–º–µ–Ω—Ç|–ª–∞–±–æ—Ä–∞—Ç–æ—Ä–Ω–∏–π —Ö–∞–ª–∞—Ç|–ª—ñ–∫–∞—Ä|–Ω–∞—É–∫–æ–≤–µ—Ü—å|–æ–¥—è–≥
ü•Ω	–∑–∞—Ö–∏—Å–Ω—ñ –æ–∫—É–ª—è—Ä–∏	–¥–∞–π–≤—ñ–Ω–≥|–∑–∞—Ö–∏—Å–Ω—ñ –æ–∫—É–ª—è—Ä–∏|–∑–∞—Ö–∏—Å—Ç|–∑–∞—Ö–∏—Å—Ç –æ—á–µ–π|–∑–≤–∞—Ä—é–≤–∞–Ω–Ω—è|–º–∞—Å–∫–∞ –¥–ª—è –¥–∞–π–≤—ñ–Ω–≥—É|–º–∞—Å–∫–∞ –¥–ª—è –ø–ª–∞–≤–∞–Ω–Ω—è|–æ–∫—É–ª—è—Ä–∏|–ø–ª–∞–≤–∞–Ω–Ω—è|—Å–∫—É–±–∞
ü•æ	–ø–æ—Ö—ñ–¥–Ω—ñ —á–µ—Ä–µ–≤–∏–∫–∏	–≤–∑—É—Ç—Ç—è|–≥—ñ—Ä—Å—å–∫—ñ|–¥–æ—Ä–æ–∂–Ω—ñ|–∫–æ—Ä–∏—á–Ω–µ–≤–µ|–ø–æ—Ö—ñ–¥|—Ç–∞–±—ñ—Ä|—Ç—Ä–µ–∫—ñ–Ω–≥–æ–≤—ñ|—Ç—É—Ä–∏—Å—Ç–∏—á–Ω—ñ|—Ö–∞–π–∫—ñ–Ω–≥|—á–æ–±–æ—Ç–∏
ü•ø	—Ç—É—Ñ–ª—ñ –±–µ–∑ –ø—ñ–¥–±–æ—Ä—ñ–≤	–±–∞–ª–µ—Ä–∏–Ω–∏|–±–∞–ª–µ—Ç–∫–∏|–∫–µ–¥–∏|—Å–ª—ñ–ø–æ–Ω–∏|—Ç–∞–ø–æ—á–∫–∏|—Ç—É—Ñ–ª—ñ|—Ç—É—Ñ–ª—ñ –±–µ–∑ –∫–∞–±–ª—É–∫–∞|—Ç—É—Ñ–ª—ñ –±–µ–∑ –ø—ñ–¥–±–æ—Ä—ñ–≤|—á–æ–≤–Ω–∏–∫–∏
ü¶Ä	–∫—Ä–∞–±	–∑–æ–¥—ñ–∞–∫|–∫—Ä–∞–±|—Ä–∞–∫
ü¶Å	–ª–µ–≤	–∑–Ω–∞–∫|–∑–æ–¥—ñ–∞–∫|–ª–µ–≤|–ª–µ–≤‚Äô—è—á–∞ –º–æ—Ä–¥–∞|–º–æ—Ä–¥–∞|–º–æ—Ä–¥–∞ –ª–µ–≤–∞|—Ç–≤–∞—Ä–∏–Ω–∞|—Ö–∏–∂–∞–∫
ü¶Ç	—Å–∫–æ—Ä–ø—ñ–æ–Ω	–∑–æ–¥—ñ–∞–∫|—Å–∫–æ—Ä–ø—ñ–æ–Ω
ü¶É	—ñ–Ω–¥–∏–∫	—ñ–Ω–¥–∏–∫|—ñ–Ω–¥–∏—á–∫–∞|–ø—Ç–∞—Ö
ü¶Ñ	—î–¥–∏–Ω–æ—Ä—ñ–≥	–≥–æ–ª–æ–≤–∞|—î–¥–∏–Ω–æ—Ä—ñ–≥|–∫–∞–∑–∫–æ–≤–∏–π|–º–æ—Ä–¥–∞
ü¶Ö	–æ—Ä–µ–ª	–æ—Ä–µ–ª|–ø—Ç–∞—Ö|—Ö–∏–∂–∞–∫
ü¶Ü	–∫–∞—á–∫–∞	–∫–∞—á–∫–∞|–ø—Ç–∞—Ö
ü¶á	–∫–∞–∂–∞–Ω	–≤–∞–º–ø—ñ—Ä|–∫–∞–∂–∞–Ω|—Ç–≤–∞—Ä–∏–Ω–∞
ü¶à	–∞–∫—É–ª–∞	–∞–∫—É–ª–∞|—Ä–∏–±–∞
ü¶â	—Å–æ–≤–∞	–±–µ–∑—Å–æ–Ω–Ω—è|–º—É–¥—Ä—ñ—Å—Ç—å|–Ω—ñ—á|–ø—ñ–∑–Ω–æ|–ø—Ç–∞—Ö|—Å–æ–≤–∞
ü¶ä	–ª–∏—Å	–ª–∏—Å|–ª–∏—Å–∏—Ü—è|–ª–∏—Å–∏—á–∞|–ª–∏—Å—è—á–∞|–º–æ—Ä–¥–∞|—Ç–≤–∞—Ä–∏–Ω–∞|—Ö–∏—Ç—Ä–∏–π
ü¶ã	–º–µ—Ç–µ–ª–∏–∫	–≥–∞—Ä–Ω–∏–π|–∫–æ–º–∞—Ö–∞|–º–µ—Ç–µ–ª–∏–∫
ü¶å	–æ–ª–µ–Ω—å	–æ–ª–µ–Ω—å|—Ä–æ–≥–∞|—Ç–≤–∞—Ä–∏–Ω–∞
ü¶ç	–≥–æ—Ä–∏–ª–∞	–≥–æ—Ä–∏–ª–∞|–º–∞–≤–ø–∞|—Ç–≤–∞—Ä–∏–Ω–∞
ü¶é	—è—â—ñ—Ä–∫–∞	–ø–ª–∞–∑—É–Ω|—Ä–µ–ø—Ç–∏–ª—ñ—è|—è—â—ñ—Ä–∫–∞
ü¶è	–Ω–æ—Å–æ—Ä—ñ–≥	–Ω–æ—Å–æ—Ä—ñ–≥|—Å–∞—Ñ–∞—Ä—ñ|—Ç–≤–∞—Ä–∏–Ω–∞
ü¶ê	–∫—Ä–µ–≤–µ—Ç–∫–∞	—ó–∂–∞|–∫—Ä–µ–≤–µ—Ç–∫–∞|–º–æ—Ä–µ–ø—Ä–æ–¥—É–∫—Ç
ü¶ë	–∫–∞–ª—å–º–∞—Ä	—ó–∂–∞|–∫–∞–ª—å–º–∞—Ä|–º–æ–ª—é—Å–∫
ü¶í	–∂–∏—Ä–∞—Ñ–∞	–∂–∏—Ä–∞—Ñ–∞|–ø–ª—è–º–∏|—Ç–≤–∞—Ä–∏–Ω–∞
ü¶ì	–∑–µ–±—Ä–∞	–∑–µ–±—Ä–∞|—Å–º—É–≥–∞|—Ç–≤–∞—Ä–∏–Ω–∞
ü¶î	—ó–∂–∞–∫	–≥–æ–ª—á–∞—Å—Ç–∏–π|—ó–∂–∞–∫|–∫–æ–ª—é—á–∏–π|–∫–æ–ª—é—á–∫–∏
ü¶ï	–∑–∞–≤—Ä–æ–ø–æ–¥	–∞–ø–∞—Ç–æ–∑–∞–≤—Ä|–±—Ä–∞—Ö—ñ–æ–∑–∞–≤—Ä|–±—Ä–æ–Ω—Ç–æ–∑–∞–≤—Ä|–¥–∏–Ω–æ–∑–∞–≤—Ä|–¥–∏–ø–ª–æ–¥–æ–∫|–∑–∞–≤—Ä–æ–ø–æ–¥|–∑–∞—É—Ä–æ–ø–æ–¥
ü¶ñ	—Ç–∏—Ä–∞–Ω–æ–∑–∞–≤—Ä	–î–∏–Ω–æ–∑–∞–≤—Ä|—Ç–∏—Ä–∞–Ω–æ–∑–∞–≤—Ä|–¢–∏—Ä–∞–Ω–æ–∑–∞–≤—Ä|—Ç–∏—Ä–∞–Ω–æ–∑–∞–≤—Ä –∫–æ—Ä–æ–ª—ñ–≤—Å—å–∫–∏–π|–¢–∏—Ä–∞–Ω–æ–∑–∞–≤—Ä –†–µ–∫—Å
ü¶ó	—Ü–≤—ñ—Ä–∫—É–Ω	–∂—É–∫|–∫–æ–º–∞—Ö–∞|–∫–æ–Ω–∏–∫|–∫—É–∫–∞—Ä–∞—á–∞|—Ç–∞—Ä–≥–∞–Ω|—Ü–≤—ñ—Ä–∫—É–Ω
ü¶ò	–∫–µ–Ω–≥—É—Ä—É	–ê–≤—Å—Ç—Ä–∞–ª—ñ—è|–∫–µ–Ω–≥—É—Ä—É|–∫–µ–Ω–≥—É—Ä—è—Ç–∫–æ|—Å—Ç—Ä–∏–±–∞—Ç–∏|—Å—Ç—Ä–∏–±–æ–∫|—Å—É–º–∫–∞|—Å—É–º—á–∞—Å—Ç–∏–π|—Å—É–º—á–∞—Å—Ç—ñ|—Ç–≤–∞—Ä–∏–Ω–∞|—Ç–æ—Ä–±—É–Ω
ü¶ô	–ª–∞–º–∞	–∞–ª—å–ø–∞–∫–∞|–≤—ñ–∫—É–Ω—å—è|–≤–æ–≤–Ω–∞|–≥—É–∞–Ω–∞–∫–æ|–ª–∞–º–∞|—Ç–≤–∞—Ä–∏–Ω–∞|—Ö—É—Ç—Ä–æ|—à–µ—Ä—Å—Ç—å
ü¶ö	–ø–∞–≤–∏—á	–∑–∞—Ä–æ–∑—É–º—ñ–ª–∏–π|–∫–æ–ª—å–æ—Ä–æ–≤–∏–π|–∫—Ä–∞—Å–∏–≤–∞|–ø–∞–≤–∞|–ø–∞–≤–ª—ñ–Ω|–ø—Ç–∞—Ö|—Ç–≤–∞—Ä–∏–Ω–∞|—Ñ–∞–∑–∞–Ω|—Ö–≤–∞–ª—å–∫—É–≤–∞—Ç–∏–π|—Ö–≤—ñ—Å—Ç
ü¶õ	–±–µ–≥–µ–º–æ—Ç	–±–µ–≥–µ–º–æ—Ç|–≥—ñ–ø–æ–ø–æ—Ç–∞–º|—Å—Å–∞–≤–µ—Ü—å|—Ç–≤–∞—Ä–∏–Ω–∞
ü¶ú	–ø–∞–ø—É–≥–∞	–∞—Ä–∞|–±–∞–ª–∞–∫—É—á–∏–π|–ø–∞–ø—É–≥–∞|–ø–∞–ø—É–∂–∫–∞|–ø—ñ—Ä–∞—Ç|–ø—Ç–∞—Ö|–ø—Ç–∞—Ö–∞|—Ä–æ–∑–º–æ–≤–ª—è—î|—Ç–≤–∞—Ä–∏–Ω–∞
ü¶ù	—î–Ω–æ—Ç	—î–Ω–æ—Ç|–ø–æ–ª–æ—Å–∫—É–Ω|—Ä–∞–∫—É–Ω|—Ç–≤–∞—Ä–∏–Ω–∞|—Ö–∏—Ç—Ä–∏–π|—Ü—ñ–∫–∞–≤–∏–π|—à–∏–±–µ–Ω–∏–∫
ü¶û	–æ–º–∞—Ä	–±—ñ—Å–∫|–¥–∞—Ä–∏ –º–æ—Ä—è|–∫–ª–µ—à–Ω—ñ|–ª–æ–±—Å—Ç–µ—Ä|–º–æ—Ä–µ–ø—Ä–æ–¥—É–∫—Ç–∏|–æ–º–∞—Ä|—Ä–∞–∫|—Ä–∞–∫–æ–≤–∏–π —Å—É–ø|—Ç–≤–∞—Ä–∏–Ω–∞|—á–µ—Ä–≤–æ–Ω–∏–π –ª–æ–±—Å—Ç–µ—Ä
ü¶ü	–∫–æ–º–∞—Ä	–≤—ñ—Ä—É—Å|–≥–∞—Ä—è—á–∫–∞|–∫–æ–º–∞—Ä|–∫–æ–º–∞—Ö–∞|–º–∞–ª—è—Ä—ñ—è|–º–æ—Å–∫—ñ—Ç|—É–∫—É—Å|—Ö–≤–æ—Ä–æ–±–∞
ü¶†	–º—ñ–∫—Ä–æ–±	–∞–º–µ–±–∞|–±–∞–∫—Ç–µ—Ä—ñ—ó|–±–∞–∫—Ç–µ—Ä—ñ—è|–≤—ñ—Ä—É—Å|–º—ñ–∫—Ä–æ–±|–º—ñ–∫—Ä–æ–±–∏|–º—ñ–∫—Ä–æ–æ—Ä–≥–∞–Ω—ñ–∑–º|–Ω–∞—É–∫–∞|—Ö–≤–æ—Ä–æ–±–∞
ü¶°	–±–æ—Ä—Å—É–∫	–±–æ—Ä—Å—É–∫|–∫—É–Ω–∏—Ü–µ–≤—ñ|–º–µ–¥–æ—ó–¥|–º—É—Å—Ç–µ–ª–æ–≤—ñ|—Å—Å–∞–≤–µ—Ü—å|—Ç–≤–∞—Ä–∏–Ω–∞|—Ö—É—Ç—Ä–æ
ü¶¢	–ª–µ–±—ñ–¥—å	–≥–∏–¥–∫–µ –∫–∞—á–µ–Ω–Ω—è|–≥–∏–¥–∫–µ –∫–∞—á–µ–Ω—è|–ª–µ–±–µ–¥–µ–Ω—è|–ª–µ–±—ñ–¥—å|–æ–∑–µ—Ä–æ|–ø—Ç–∞—Ö|–ø—Ç–∞—Ö–∞|—Ç–≤–∞—Ä–∏–Ω–∞
ü¶£	–º–∞–º–æ–Ω—Ç	–±–∏–≤–µ–Ω—å|–≤–µ–ª–∏–∫–∏–π|–≤–∏–º–∏—Ä–∞–Ω–Ω—è|–≤–æ–ª–æ—Ö–∞—Ç–∏–π|–∫–∞–º‚Äô—è–Ω–∏–π –≤—ñ–∫|–º–∞–º–æ–Ω—Ç|—Ç–≤–∞—Ä–∏–Ω–∞
ü¶§	–¥—Ä–æ–Ω—Ç	–≤–µ–ª–∏–∫–∏–π|–≤–∏–º–∏—Ä–∞–Ω–Ω—è|–¥–æ–¥–æ|–¥—Ä–æ–Ω—Ç|–º–∞–≤—Ä–∏–∫—ñ–π—Å—å–∫–∏–π|–ø—Ç–∞—Ö|—Ç–≤–∞—Ä–∏–Ω–∞
ü¶•	–ª—ñ–Ω–∏–≤–µ—Ü—å	–ª–µ–¥–∞—á–∏–π|–ª—ñ–Ω–∏–≤–µ—Ü—å|–ª—ñ–Ω–∏–≤–∏–π|–º–ª—è–≤–∏–π|–ø–æ–≤—ñ–ª—å–Ω–∏–π|—Ç–≤–∞—Ä–∏–Ω–∞
ü¶¶	–≤–∏–¥—Ä–∞	–≤–∏–¥—Ä–∞|–≤–æ–¥—è–Ω–∏–π –∑–≤—ñ—Ä|–≥—Ä–∞–π–ª–∏–≤–∏–π|—Ä–∏–±–∞–ª–∫–∞|—Ç–≤–∞—Ä–∏–Ω–∞
ü¶ß	–æ—Ä–∞–Ω–≥—É—Ç–∞–Ω–≥	–∞–Ω—Ç—Ä–æ–ø–æ—ó–¥|–ª—é–¥–∏–Ω–æ–ø–æ–¥—ñ–±–Ω–∞|–º–∞–≤–ø–∞|–æ—Ä–∞–Ω–≥—É—Ç–∞–Ω–≥|–ø—Ä–∏–º–∞—Ç|—Ç–≤–∞—Ä–∏–Ω–∞
ü¶®	—Å–∫—É–Ω—Å	—Å–∫—É–Ω—Å|—Å–º–µ—Ä–¥—ñ—Ç–∏|—Å–º–æ—Ä—ñ–¥|—Ç–≤–∞—Ä–∏–Ω–∞|—Ç—Ö–Ω—É—Ç–∏
ü¶©	—Ñ–ª–∞–º—ñ–Ω–≥–æ	–ø—Ç–∞—Ö|—Ä–æ–∂–µ–≤–∏–π|—Ç—Ä–æ–ø—ñ–∫–∏|—Ç—Ä–æ–ø—ñ—á–Ω–∏–π|—Ñ–ª–∞–º—ñ–Ω–≥–æ
ü¶™	—É—Å—Ç—Ä–∏—Ü—è	–º—É—à–ª—è|–ø–µ—Ä–ª–∏|–ø–µ—Ä–ª–∏–Ω–∞|—É—Å—Ç—Ä–∏—Ü—è|—É—Å—Ç—Ä–∏—á–Ω–∏–π
ü¶´	–±–æ–±–µ—Ä	–±–æ–±–µ—Ä|–±–æ–±—Ä–∏|–±–æ–±—Ä–æ–≤–∞|–±–æ–±—Ä–æ–≤–∏–¥–Ω—ñ|–≥—Ä–µ–±–ª—è|–≥—Ä–∏–∑—Ç–∏|–∑—É–±–∞—Ç–∏–π|–∑—É–±–∏|—Ç–≤–∞—Ä–∏–Ω–∞
ü¶¨	–±—ñ–∑–æ–Ω	–±—ñ–∑–æ–Ω|–±—É–π–≤–æ–ª|–∑—É–±—Ä|—Ä–æ–≥–∞—Ç–∞ —Ç–≤–∞—Ä–∏–Ω–∞|—Ä–æ–≥–∏|—Å–≤—ñ–π—Å—å–∫–∞ —Ç–≤–∞—Ä–∏–Ω–∞|—Å—Ç–∞–¥–æ|—Ç–≤–∞—Ä–∏–Ω–∞|—Ö—É–¥–æ–±–∞
ü¶≠	—Ç—é–ª–µ–Ω—å	–∞—Ä–∫—Ç–∏–∫–∞|–º–æ—Ä—Å—å–∫–∏–π –∫–æ—Ç–∏–∫|–º–æ—Ä—Å—å–∫–∏–π –ª–µ–≤|–æ–∫–µ–∞–Ω|—Ç–≤–∞—Ä–∏–Ω–∞|—Ç—é–ª–µ–Ω—å
ü¶Æ	—Å–æ–±–∞–∫–∞-–ø–æ–≤–æ–¥–∏—Ä	–¥–ª—è –Ω–µ–∑—Ä—è—á–∏—Ö|–¥–æ—Å—Ç—É–ø–Ω—ñ—Å—Ç—å|–ø–æ–≤–æ–¥–∏—Ä|—Å–æ–±–∞–∫–∞-–ø–æ–≤–æ–¥–∏—Ä|—Å–ø–µ—Ü—ñ–∞–ª—å–Ω—ñ –º–æ–∂–ª–∏–≤–æ—Å—Ç—ñ
ü¶Ø	—Ç–∞–∫—Ç–∏–ª—å–Ω–∞ —Ç—Ä–æ—Å—Ç–∏–Ω–∞	–¥–æ—Å—Ç—É–ø–Ω—ñ—Å—Ç—å|–Ω–µ–∑—Ä—è—á—ñ|–Ω–µ–∑—Ä—è—á—ñ—Å—Ç—å|—Å–ª—ñ–ø–æ—Ç–∞|—Å–ø–µ—Ü—ñ–∞–ª—å–Ω—ñ –∑–∞—Å–æ–±–∏|—Ç–∞–∫—Ç–∏–ª—å–Ω–∞ —Ç—Ä–æ—Å—Ç–∏–Ω–∞
ü¶¥	–∫—ñ—Å—Ç–∫–∞	–∫–∞–ª—å—Ü—ñ–π|–∫—ñ—Å—Ç–∫–∞|–∫—ñ—Å—Ç–æ—á–∫–∞|–∫–æ—Å—Ç—ñ|—Å–∫–µ–ª–µ—Ç|—Å–æ–±–∞–∫–∞|—Å–æ–±–∞—á—ñ –ª–∞—Å–æ—â—ñ
ü¶µ	–Ω–æ–≥–∞	–∑—ñ–≥–Ω—É—Ç–∞ –Ω–æ–≥–∞|–∫—ñ–Ω—Ü—ñ–≤–∫–∞|–∫–æ–ª—ñ–Ω–æ|–∫–æ–ø–Ω—è–∫|–Ω–æ–≥–∞|—Å—Ç–µ–≥–Ω–æ|—Å—Ç–æ–ø–∞|—É–¥–∞—Ä –Ω–æ–≥–æ—é
ü¶∂	—Å—Ç—É–ø–Ω—è	–≥–æ–º—ñ–ª–∫–∞|–Ω—ñ–∂–∫–∞|–Ω–æ–≥–∞|—Å—Ç–æ–ø–∞|—Å—Ç–æ–ø–∏|—Å—Ç—É–ø–Ω—è|—É–¥–∞—Ä
ü¶∑	–∑—É–±	–±—ñ–ª–∏–π|–¥–∞–Ω—Ç–∏—Å—Ç|–∑—É–±|–∑—É–±–∏|—Å—Ç–æ–º–∞—Ç–æ–ª–æ–≥
ü¶∏	—Å—É–ø–µ—Ä–≥–µ—Ä–æ–π	–≥–µ—Ä–æ—ó–Ω—è|–≥–µ—Ä–æ–π|–¥–æ–±—Ä–∏–π|–¥–æ–±—Ä–æ|—Å—É–ø–µ—Ä–≥–µ—Ä–æ–π|—Å—É–ø–µ—Ä–º–µ–Ω|—Å—É–ø–µ—Ä—Å–∏–ª–∞|—Å—É–ø–µ—Ä—Å–∏–ª–∏
ü¶π	—Å—É–ø–µ—Ä–∑–ª–æ–¥—ñ–π	–∑–ª–æ|–∑–ª–æ–¥—ñ–π|–∑–ª–æ—á–∏–Ω–µ—Ü—å|–ª–∏—Ö–∏–π|–ª–∏—Ö–æ–¥—ñ–π|–ø–æ–≥–∞–Ω–∏–π|—Å—É–ø–µ—Ä–∑–ª–æ–¥—ñ–π|—Å—É–ø–µ—Ä–∑–ª–æ—á–∏–Ω–µ—Ü—å|—Å—É–ø–µ—Ä–ª–∏—Ö–æ–¥—ñ–π|—Å—É–ø–µ—Ä—Å–∏–ª–∞
ü¶∫	—Å–∏–≥–Ω–∞–ª—å–Ω–∏–π –∂–∏–ª–µ—Ç	–∞–≤–∞—Ä—ñ–π–Ω–æ-–∑–∞—Ö–∏—Å–Ω–∏–π|–∞–≤–∞—Ä—ñ–π–Ω–æ-—Ä—è—Ç—É–≤–∞–ª—å–Ω–∏–π|–∂–∏–ª–µ—Ç|—Å–∏–≥–Ω–∞–ª—å–Ω–∏–π –∂–∏–ª–µ—Ç
ü¶ª	–≤—É—Ö–æ –∑—ñ —Å–ª—É—Ö–æ–≤–∏–º –∞–ø–∞—Ä–∞—Ç–æ–º	–≤–∞–¥–∏ —Å–ª—É—Ö—É|–≤—É—Ö–æ –∑—ñ —Å–ª—É—Ö–æ–≤–∏–º –∞–ø–∞—Ä–∞—Ç–æ–º|–¥–æ—Å—Ç—É–ø–Ω—ñ—Å—Ç—å|—Å–ª—É—Ö–æ–≤–∏–π –∞–ø–∞—Ä–∞—Ç|—Å–ø–µ—Ü—ñ–∞–ª—å–Ω—ñ –º–æ–∂–ª–∏–≤–æ—Å—Ç—ñ
ü¶º	–∫–æ–ª—ñ—Å–Ω–∏–π –≤—ñ–∑–æ–∫ –∑ –µ–ª–µ–∫—Ç—Ä–æ–ø—Ä–∏–≤–æ–¥–æ–º	–¥–æ—Å—Ç—É–ø–Ω—ñ—Å—Ç—å|–∫–æ–ª—ñ—Å–Ω–∏–π –≤—ñ–∑–æ–∫ –∑ –µ–ª–µ–∫—Ç—Ä–æ–ø—Ä–∏–≤–æ–¥–æ–º|—Å–ø–µ—Ü—ñ–∞–ª—å–Ω–∏–π –∑–∞—Å—ñ–±|—Å–ø–µ—Ü—ñ–∞–ª—å–Ω—ñ –º–æ–∂–ª–∏–≤–æ—Å—Ç—ñ
ü¶Ω	–∫–æ–ª—ñ—Å–Ω–∏–π –≤—ñ–∑–æ–∫ —ñ–∑ —Ä—É—á–Ω–∏–º –ø—Ä–∏–≤–æ–¥–æ–º	–¥–æ—Å—Ç—É–ø–Ω—ñ—Å—Ç—å|–∫–æ–ª—ñ—Å–Ω–∏–π –≤—ñ–∑–æ–∫ —ñ–∑ —Ä—É—á–Ω–∏–º –ø—Ä–∏–≤–æ–¥–æ–º|–æ–±–º–µ–∂–µ–Ω—ñ –º–æ–∂–ª–∏–≤–æ—Å—Ç—ñ|—Å–ø–µ—Ü—ñ–∞–ª—å–Ω–∏–π –∑–∞—Å—ñ–±
ü¶æ	–º–µ—Ö–∞–Ω—ñ—á–Ω–∞ —Ä—É–∫–∞	–¥–æ—Å—Ç—É–ø–Ω—ñ—Å—Ç—å|–º–µ—Ö–∞–Ω—ñ—á–Ω–∞ —Ä—É–∫–∞|–ø—Ä–æ—Ç–µ–∑|—Å–ø–µ—Ü—ñ–∞–ª—å–Ω—ñ –º–æ–∂–ª–∏–≤–æ—Å—Ç—ñ
ü¶ø	–º–µ—Ö–∞–Ω—ñ—á–Ω–∞ –Ω–æ–≥–∞	–¥–æ—Å—Ç—É–ø–Ω—ñ—Å—Ç—å|–º–µ—Ö–∞–Ω—ñ—á–Ω–∞ –Ω–æ–≥–∞|–ø—Ä–æ—Ç–µ–∑|—Å–ø–µ—Ü—ñ–∞–ª—å–Ω—ñ –º–æ–∂–ª–∏–≤–æ—Å—Ç—ñ
üßÄ	–∫—É—Å–µ–Ω—å —Å–∏—Ä—É	—ó–∂–∞|–∫—É—Å–µ–Ω—å —Å–∏—Ä—É|—Å–∏—Ä|—à–º–∞—Ç–æ–∫ —Å–∏—Ä—É
üßÅ	–∫–∞–ø–∫–µ–π–∫	–≤–∏–ø—ñ—á–∫–∞|–¥–µ—Å–µ—Ä—Ç|–∫–∞–ø–∫–µ–π–∫|–∫–µ–∫—Å|–ª–∞—Å–æ—â—ñ|–ø–æ—Å–∏–ø–∫–∞|—Å–º–∞–∫–æ–ª–∏–∫|—Å–æ–ª–æ–¥–∫–µ|—Å–æ–ª–æ–¥–æ—â—ñ|—Ç—ñ—Å—Ç–µ—á–∫–æ|—Ç–æ—Ä—Ç
üßÇ	—Å—ñ–ª—å	–∞—Ä–æ–º–∞—Ç|–ø—Ä–∏–ø—Ä–∞–≤–∞|—Å–≤–∞—Ä–∫–∞|—Å—ñ–ª—å|—Å—ñ–ª—å–Ω–∏—Ü—è|—Å—ñ–ª—å–Ω–∏—á–∫–∞|—Å–º–∞–∫|—Å–æ–ª–æ–Ω–∏–π|—Å–ø–µ—Ü—ñ—ó
üßÉ	–ø–∞–∫–µ—Ç–∏–∫ —ñ–∑ –Ω–∞–ø–æ—î–º	–∫–∞—Ä—Ç–æ–Ω–Ω–∏–π|–Ω–∞–ø—ñ–π|–ø–∞–∫–µ—Ç|–ø–∞–∫–µ—Ç–∏–∫ —ñ–∑ –Ω–∞–ø–æ—î–º|—Å—ñ–∫|—Å–æ–ª–æ–º–∏–Ω–∫–∞|—Ñ—Ä—É–∫—Ç–æ–≤–∏–π —Å—ñ–∫
üßÑ	—á–∞—Å–Ω–∏–∫	—ó–∂–∞|–ø—Ä–∏–ø—Ä–∞–≤–∞|—Å–ø–µ—Ü—ñ—ó|—á–∞—Å–Ω–∏–∫|—á–∞—Å–Ω–∏–∫–æ–≤–∏–π
üßÖ	—Ü–∏–±—É–ª—è	–∑ —Ü–∏–±—É–ª—ñ|—ó–∂–∞|–ø—Ä–∏–ø—Ä–∞–≤–∞|—Å–ø–µ—Ü—ñ—ó|—Ü–∏–±—É–ª–∏–Ω–Ω–∏–π|—Ü–∏–±—É–ª—è
üßÜ	—Ñ–∞–ª–∞—Ñ–µ–ª—å	–∫—É–ª—å–∫–∞ –∑ –Ω—É—Ç—É|–Ω—É—Ç|—Ñ–∞–ª–∞—Ñ–µ–ª—å
üßá	–≤–∞—Ñ–ª—è	–≤–∞—Ñ–µ–ª—å–Ω–∏–π|–≤–∞—Ñ–ª—ñ|–≤–∞—Ñ–ª—è|–¥–µ—Å–µ—Ä—Ç|—ó–∂–∞|—Å–Ω—ñ–¥–∞–Ω–æ–∫|—Å–æ–ª–æ–¥–æ—â—ñ
üßà	–º–∞—Å–ª–æ	–º–∞—Å–ª–æ|–º–æ–ª–æ—á–Ω—ñ –ø—Ä–æ–¥—É–∫—Ç–∏
üßâ	–º–∞—Ç–µ	–∫–∞–ª–∞–±–∞—Å|–º–∞—Ç–µ|–Ω–∞–ø—ñ–π|—á–∞–π —ñ–∑ –ø–∞–¥—É–±–∞
üßä	–∫—É–±–∏–∫ –ª—å–æ–¥—É	–∞–π—Å–±–µ—Ä–≥|–∫—É–±–∏–∫|–∫—É–±–∏–∫ –ª—å–æ–¥—É|–æ—Ö–æ–ª–æ–¥–∂—É–≤–∞—Ç–∏|—Ö–æ–ª–æ–¥|—Ö–æ–ª–æ–¥–Ω–∏–π
üßã	–±—É–ª—å–±–∞—à–∫–æ–≤–∏–π —á–∞–π	–±—É–ª—å–±–∞—à–∫–æ–≤–∏–π|–∫–æ–∫—Ç–µ–π–ª—å|–º–æ–ª–æ—á–Ω–∏–π|–Ω–∞–ø—ñ–π|–ø–µ—Ä–ª–æ–≤–∏–π|—Å–æ–ª–æ–º–∏–Ω–∫–∞|—Ç–∞–π–≤–∞–Ω—å|—á–∞–π|—á–∞–π –∑ –±—É–ª—å–±–∞—à–∫–∞–º–∏
üßå	—Ç—Ä–æ–ª—å	–∫–∞–∑–∫–∞|–º–æ–Ω—Å—Ç—Ä|—Ç—Ä–æ–ª—ñ–Ω–≥|—Ç—Ä–æ–ª—å|—Ñ–µ–Ω—Ç–µ–∑—ñ
üßç	–ª—é–¥–∏–Ω–∞, —â–æ —Å—Ç–æ—ó—Ç—å	–ª—é–¥–∏–Ω–∞|–ª—é–¥–∏–Ω–∞, —â–æ —Å—Ç–æ—ó—Ç—å|—Å—Ç–æ—è–Ω–Ω—è|—Å—Ç–æ—è—Ç–∏|—Å—Ç–æ—è—á–∏|—Å—Ç–æ—è—á–∫–∏|—â–æ —Å—Ç–æ—ó—Ç—å
üßé	–ª—é–¥–∏–Ω–∞ –Ω–∞–≤–∫–æ–ª—ñ—à–∫–∞—Ö	–∫–æ–ª—ñ–Ω–∞|–ª—é–¥–∏–Ω–∞ –Ω–∞–≤–∫–æ–ª—ñ—à–∫–∞—Ö|–Ω–∞ –∫–æ–ª—ñ–Ω–∞—Ö|–Ω–∞–≤–∫–æ–ª—ñ—à–∫–∞—Ö|–æ–ø—É—Å–∫–∞—Ç–∏—Å—è –Ω–∞–≤–∫–æ–ª—ñ—à–∫–∏
üßè	–ª—é–¥–∏–Ω–∞ –∑ –ø–æ—Ä—É—à–µ–Ω–Ω—è–º —Å–ª—É—Ö—É	–≤–∞–¥–∞ —Å–ª—É—Ö—É|–≥–ª—É—Ö–æ—Ç–∞|–¥–æ—Å—Ç—É–ø–Ω—ñ—Å—Ç—å|–ª—é–¥–∏–Ω–∞ –∑ –ø–æ—Ä—É—à–µ–Ω–Ω—è–º —Å–ª—É—Ö—É|—Å–ª—É—Ö|—Å–ø–µ—Ü—ñ–∞–ª—å–Ω—ñ –º–æ–∂–ª–∏–≤–æ—Å—Ç—ñ|—á—É—Ç–∏
üßê	–æ–±–ª–∏—á—á—è –≤ –º–æ–Ω–æ–∫–ª—ñ	–∑–±—ñ–ª—å—à—É–≤–∞–ª—å–Ω–µ —Å–∫–ª–æ|–ª—É–ø–∞|–º–æ–Ω–æ–∫–ª—å|–æ–±–ª–∏—á—á—è –≤ –º–æ–Ω–æ–∫–ª—ñ|–æ–±–ª–∏—á—á—è –∑ –º–æ–Ω–æ–∫–ª–µ–º|–ø–∞–Ω–æ–≤–∏—Ç–∏–π|–ø—Ä–∏–¥–∏–≤–ª—è—Ç–∏—Å—è
üßë	–ª—é–¥–∏–Ω–∞	–≥–µ–Ω–¥–µ—Ä–Ω–æ-–Ω–µ–π—Ç—Ä–∞–ª—å–Ω–∏–π|–¥–æ—Ä–æ—Å–ª–∏–π|–ª—é–¥–∏–Ω–∞|–Ω–µ–æ–∑–Ω–∞—á–µ–Ω–æ—ó —Å—Ç–∞—Ç—ñ|—Ö–ª–æ–ø–µ—Ü—å|—Ö–ª–æ–ø—á–∏–∫
üßë‚Äçüåæ	—Å–µ–ª—è–Ω–∏–Ω	–∑–µ–º–ª–µ—Ä–æ–±|—Å–∞–¥—ñ–≤–Ω–∏–∫|—Å–µ–ª—è–Ω–∏–Ω|—Å–∫–æ—Ç–∞—Ä
üßë‚Äçüç≥	–∫—É—Ö–æ–≤–∞—Ä	–∫—É—Ö–∞—Ä|–∫—É—Ö–æ–≤–∞—Ä|—à–µ—Ñ
üßë‚Äçüçº	–ª—é–¥–∏–Ω–∞ –≥–æ–¥—É—î –¥–∏—Ç–∏–Ω—É	–±–∞—Ç—å–∫—ñ–≤—Å—Ç–≤–æ|–±–∞—Ç—å–∫–æ|–≥–æ–¥—É–≤–∞–Ω–Ω—è|–≥–æ–¥—É–≤–∞—Ç–∏ –Ω–µ–º–æ–≤–ª—è|–¥–∏—Ç–∏–Ω–∞|–¥–æ–≥–ª—è–¥|–ª—é–¥–∏–Ω–∞|–ª—é–¥–∏–Ω–∞ –≥–æ–¥—É—î –¥–∏—Ç–∏–Ω—É|–º–∞–º–∞|–º–∞—Ç–∏|–Ω–µ–º–æ–≤–ª—è|—Ç–∞—Ç–æ
üßë‚ÄçüéÑ	–ú—ñ–∫—Å –ö–ª–∞—É—Å	–ö–ª–∞—É—Å|–ª—é–¥–∏–Ω–∞|–ú—ñ–∫—Å –ö–ª–∞—É—Å|—Ä—ñ–∑–¥–≤–æ|–†—ñ–∑–¥–≤–æ|—Ä—ñ–∑–¥–≤—è–Ω—ñ —Å–≤—è—Ç–∞|—Å–∞–Ω—Ç–∞|—Å–≤—è—Ç–æ|—à–∞–ø–∫–∞ —Å–∞–Ω—Ç–∏
üßë‚Äçüéì	—Å–ª—É—Ö–∞—á	–≤–∏–ø—É—Å–∫–Ω–∏–∫|—Å–ª—É—Ö–∞—á|—Å—Ç—É–¥–µ–Ω—Ç
üßë‚Äçüé§	–≤–æ–∫–∞–ª—ñ—Å—Ç	–∞–∫—Ç–æ—Ä|–∞—Ä—Ç–∏—Å—Ç|–≤–æ–∫–∞–ª—ñ—Å—Ç|–∑—ñ—Ä–∫–∞|—Ä–æ–∫|—Å–ø—ñ–≤–∞–∫
üßë‚Äçüé®	—Ö—É–¥–æ–∂–Ω–∏–∫	–º–∏—Ç–µ—Ü—å|–ø–∞–ª—ñ—Ç—Ä–∞|—Ö—É–¥–æ–∂–Ω–∏–∫
üßë‚Äçüè´	–æ—Å–≤—ñ—Ç—è–Ω–∏–Ω	–≤–∏–∫–ª–∞–¥–∞—á|—ñ–Ω—Å—Ç—Ä—É–∫—Ç–æ—Ä|–æ—Å–≤—ñ—Ç—è–Ω–∏–Ω|—É—á–∏—Ç–µ–ª—å
üßë‚Äçüè≠	—Ñ–∞–±—Ä–∏—á–Ω–∏–π –ø—Ä–∞—Ü—ñ–≤–Ω–∏–∫	–∑–∞–≤–æ–¥|–∫–æ–Ω–≤–µ—î—Ä|–ø—Ä–æ–º–∏—Å–ª–æ–≤—ñ—Å—Ç—å|—Ä–æ–±—ñ—Ç–Ω–∏–∫|—Ñ–∞–±—Ä–∏—á–Ω–∏–π –ø—Ä–∞—Ü—ñ–≤–Ω–∏–∫
üßë‚Äçüíª	—Ç–µ—Ö–Ω—ñ—á–Ω–∏–π –ø—Ä–∞—Ü—ñ–≤–Ω–∏–∫	–≤–∏–Ω–∞—Ö—ñ–¥–Ω–∏–∫|–ø—Ä–æ–≥—Ä–∞–º—ñ—Å—Ç|–ø—Ä–æ–≥—Ä–∞–º–Ω–µ –∑–∞–±–µ–∑–ø–µ—á–µ–Ω–Ω—è|—Ä–æ–∑—Ä–æ–±–Ω–∏–∫|—Ç–µ—Ö–Ω—ñ—á–Ω–∏–π –ø—Ä–∞—Ü—ñ–≤–Ω–∏–∫|—Ç–µ—Ö–Ω–æ–ª–æ–≥
üßë‚Äçüíº	–æ—Ñ—ñ—Å–Ω–∏–π –ø—Ä–∞—Ü—ñ–≤–Ω–∏–∫	–∞—Ä—Ö—ñ—Ç–µ–∫—Ç–æ—Ä|–±—ñ–∑–Ω–µ—Å|–±—ñ–ª–∏–π –∫–æ–º—ñ—Ä–µ—Ü—å|–º–µ–Ω–µ–¥–∂–µ—Ä|–æ—Ñ—ñ—Å–Ω–∏–π –ø—Ä–∞—Ü—ñ–≤–Ω–∏–∫
üßë‚Äçüîß	—Ñ–∞—Ö—ñ–≤–µ—Ü—å —ñ–∑ –º–µ—Ö–∞–Ω—ñ–∫–∏	–µ–ª–µ–∫—Ç—Ä–∏–∫|–º–∞–π—Å—Ç–µ—Ä|–º–µ—Ö–∞–Ω—ñ–∫|—Å–∞–Ω—Ç–µ—Ö–Ω—ñ–∫|—Ñ–∞—Ö—ñ–≤–µ—Ü—å —ñ–∑ –º–µ—Ö–∞–Ω—ñ–∫–∏
üßë‚Äçüî¨	–Ω–∞—É–∫–æ–≤–∏–π –ø—Ä–∞—Ü—ñ–≤–Ω–∏–∫	–±—ñ–æ–ª–æ–≥|—ñ–Ω–∂–µ–Ω–µ—Ä|–Ω–∞—É–∫–æ–≤–µ—Ü—å|–Ω–∞—É–∫–æ–≤–∏–π –ø—Ä–∞—Ü—ñ–≤–Ω–∏–∫|—Ñ—ñ–∑–∏–∫|—Ö—ñ–º—ñ–∫
üßë‚ÄçüöÄ	–∫–æ—Å–º–æ–Ω–∞–≤—Ç	–∫–æ—Å–º–æ–Ω–∞–≤—Ç|—Ä–∞–∫–µ—Ç–∞
üßë‚Äçüöí	–≤–æ–≥–Ω–µ–±–æ—Ä–µ—Ü—å	–≤–æ–≥–Ω–µ–±–æ—Ä–µ—Ü—å|–ø–æ–∂–µ–∂–Ω–∞ –º–∞—à–∏–Ω–∞|–ø–æ–∂–µ–∂–Ω–∏–∫
üßë‚Äçü§ù‚Äçüßë	–ª—é–¥–∏, —â–æ —Ç—Ä–∏–º–∞—é—Ç—å—Å—è –∑–∞ —Ä—É–∫–∏	–ª—é–¥–∏|–ª—é–¥–∏, —â–æ —Ç—Ä–∏–º–∞—é—Ç—å—Å—è –∑–∞ —Ä—É–∫–∏|–ª—é–¥–∏–Ω–∞|–ø–∞—Ä–∞|—Ä—É–∫–∞|—Ä—É–∫–∏|—Ç—Ä–∏–º–∞—Ç–∏|—Ç—Ä–∏–º–∞—é—Ç—å—Å—è|—â–æ —Ç—Ä–∏–º–∞—é—Ç—å—Å—è –∑–∞ —Ä—É–∫–∏
üßë‚Äçü¶Ø	–ª—é–¥–∏–Ω–∞ –∑ —Ç–∞–∫—Ç–∏–ª—å–Ω–∏–º —Ü—ñ–ø–∫–æ–º	–±—ñ–ª–∞|–±—ñ–ª–∏–π|–¥–æ—Å—Ç—É–ø–Ω—ñ—Å—Ç—å|–Ω–µ–∑—Ä—è—á—ñ|—Å–ø–µ—Ü—ñ–∞–ª—å–Ω—ñ –º–æ–∂–ª–∏–≤–æ—Å—Ç—ñ|—Ç—Ä–æ—Å—Ç–∏–Ω–∞|—Ü—ñ–ø–æ–∫
üßë‚Äçü¶º	–ª—é–¥–∏–Ω–∞ –Ω–∞ –º–æ—Ç–æ—Ä–∏–∑–æ–≤–∞–Ω–æ–º—É –≤—ñ–∑–∫—É	–∫–æ–ª—ñ—Å–Ω–µ –∫—Ä—ñ—Å–ª–æ|–ª—é–¥–∏–Ω–∞ –Ω–∞ –º–æ—Ç–æ—Ä–∏–∑–æ–≤–∞–Ω–æ–º—É –≤—ñ–∑–∫—É|—Å–ø–µ—Ü—ñ–∞–ª—å–Ω—ñ –º–æ–∂–ª–∏–≤–æ—Å—Ç—ñ
üßë‚Äçü¶Ω	–ª—é–¥–∏–Ω–∞ —É –≤—ñ–∑–∫—É –∑ —Ä—É—á–Ω–∏–º –∫–µ—Ä—É–≤–∞–Ω–Ω—è–º	–∫–æ–ª—ñ—Å–Ω–µ –∫—Ä—ñ—Å–ª–æ|–ª—é–¥–∏–Ω–∞ —É –≤—ñ–∑–∫—É –∑ —Ä—É—á–Ω–∏–º –∫–µ—Ä—É–≤–∞–Ω–Ω—è–º|—Å–ø–µ—Ü—ñ–∞–ª—å–Ω—ñ –º–æ–∂–ª–∏–≤–æ—Å—Ç—ñ
üßë‚Äçüßë‚Äçüßí	—Ä–æ–¥–∏–Ω–∞: –¥–æ—Ä–æ—Å–ª–∏–π, –¥–æ—Ä–æ—Å–ª–∏–π, –¥–∏—Ç–∏–Ω–∞	–¥–∏—Ç–∏–Ω–∞|–¥–æ—Ä–æ—Å–ª–∏–π|—Ä–æ–¥–∏–Ω–∞ –∑ –¥–∏—Ç–∏–Ω–æ—é|—Ä–æ–¥–∏–Ω–∞: –¥–≤–æ—î –¥–æ—Ä–æ—Å–ª–∏—Ö —ñ –¥–∏—Ç–∏–Ω–∞|—Ä–æ–¥–∏–Ω–∞: –¥–æ—Ä–æ—Å–ª–∏–π|—Ä–æ–¥–∏–Ω–∞: –¥–æ—Ä–æ—Å–ª–∏–π, –¥–æ—Ä–æ—Å–ª–∏–π, –¥–∏—Ç–∏–Ω–∞
üßë‚Äçüßë‚Äçüßí‚Äçüßí	—Ä–æ–¥–∏–Ω–∞: –¥–≤–æ—î –¥–æ—Ä–æ—Å–ª–∏—Ö —ñ –¥–≤–æ—î –¥—ñ—Ç–µ–π	–¥–≤–æ—î –¥–æ—Ä–æ—Å–ª–∏—Ö —ñ –¥–≤–æ—î –¥—ñ—Ç–µ–π|—Ä–æ–¥–∏–Ω–∞: –¥–≤–æ—î –¥–æ—Ä–æ—Å–ª–∏—Ö —ñ –¥–≤–æ—î –¥—ñ—Ç–µ–π|—Ä–æ–¥–∏–Ω–∞: –¥–æ—Ä–æ—Å–ª—ñ —Ç–∞ –¥—ñ—Ç–∏
üßë‚Äçüßí	—Ä–æ–¥–∏–Ω–∞: –¥–æ—Ä–æ—Å–ª–∏–π —ñ –¥–∏—Ç–∏–Ω–∞	—Ä–æ–¥–∏–Ω–∞: –¥–æ—Ä–æ—Å–ª–∏–π —ñ –¥–∏—Ç–∏–Ω–∞
üßë‚Äçüßí‚Äçüßí	—Ä–æ–¥–∏–Ω–∞: –¥–æ—Ä–æ—Å–ª–∏–π —ñ –¥—ñ—Ç–∏	—Ä–æ–¥–∏–Ω–∞: –¥–æ—Ä–æ—Å–ª–∏–π —ñ –¥–≤–æ—î –¥—ñ—Ç–µ–π|—Ä–æ–¥–∏–Ω–∞: –¥–æ—Ä–æ—Å–ª–∏–π —ñ –¥—ñ—Ç–∏
üßí	–¥–∏—Ç–∏–Ω–∞	–≤–µ—Å–µ–ª–æ|–≥–µ–Ω–¥–µ—Ä–Ω–æ-–Ω–µ–π—Ç—Ä–∞–ª—å–Ω–∏–π|–¥–∏—Ç–∏–Ω–∞|–ª—é–¥–∏–Ω–∞|–º–∞–ª–µ—á–∞|–Ω–µ–æ–∑–Ω–∞—á–µ–Ω–æ—ó —Å—Ç–∞—Ç—ñ|—Å–º—ñ—Ö
üßì	–ª—ñ—Ç–Ω—è –ª—é–¥–∏–Ω–∞	–≥–µ–Ω–¥–µ—Ä–Ω–æ-–Ω–µ–π—Ç—Ä–∞–ª—å–Ω–∏–π|–¥—ñ–¥—É—Å—å|–¥–æ—Ä–æ—Å–ª–∏–π|–ª—ñ—Ç–Ω—è –ª—é–¥–∏–Ω–∞|–ª—é–¥–∏–Ω–∞|–Ω–µ–æ–∑–Ω–∞—á–µ–Ω–æ—ó —Å—Ç–∞—Ç—ñ|—Å—Ç–∞—Ä–∏–π|—Å—Ç–∞—Ä—à–∞ –ª—é–¥–∏–Ω–∞|—á–æ–ª–æ–≤—ñ–∫
üßî	–ª—é–¥–∏–Ω–∞ –∑ –±–æ—Ä–æ–¥–æ—é	–±–æ—Ä–æ–¥–∞|–±–æ—Ä–æ–¥–∞–Ω—å|–±–æ—Ä–æ–¥–∞—Ç–∏–π|–ª—é–¥–∏–Ω–∞ –∑ –±–æ—Ä–æ–¥–æ—é
üßï	–∂—ñ–Ω–∫–∞ –≤ —Ö—É—Å—Ç–∏–Ω—ñ	–∂—ñ–Ω–∫–∞ –≤ —Ö—É—Å—Ç–∏–Ω—ñ|–º–∞–Ω—Ç–∏–ª—å—è|–º–æ–Ω–∞—Ö–∏–Ω—è|—Ç–∏—Ö–ª—è|—Ö—ñ–¥–∂–∞–±|—Ö—É—Å—Ç–∏–Ω–∞
üßñ	–ª—é–¥–∏–Ω–∞ –≤ –ø–∞—Ä–∫–æ–º—É –ø—Ä–∏–º—ñ—â–µ–Ω–Ω—ñ	–ª—é–¥–∏–Ω–∞ –≤ –ª–∞–∑–Ω—ñ|–ª—é–¥–∏–Ω–∞ –≤ –ø–∞—Ä–∫–æ–º—É –ø—Ä–∏–º—ñ—â–µ–Ω–Ω—ñ|–ø–∞—Ä–∏–ª—å–Ω—è|—Ä–µ–ª–∞–∫—Å|—Å–∞—É–Ω–∞|—Ö–∞–º–∞–º
üßó	–ª—é–¥–∏–Ω–∞, —â–æ –ª—ñ–∑–µ —Å–∫–µ–ª–µ—é	–∞–ª—å–ø—ñ–Ω—ñ–∑–º|–∞–ª—å–ø—ñ–Ω—ñ—Å—Ç|–∞–ª—å–ø—ñ–Ω—ñ—Å—Ç–∫–∞|–ª—ñ–∑—Ç–∏ –≤–≥–æ—Ä—É|–ª—é–¥–∏–Ω–∞|–ª—é–¥–∏–Ω–∞, —â–æ –ª—ñ–∑–µ —Å–∫–µ–ª–µ—é|—Å–∫–µ–ª–µ–ª–∞–∑|—â–æ –ª—ñ–∑–µ —Å–∫–µ–ª–µ—é
üßò	–ª—é–¥–∏–Ω–∞ –≤ –ø–æ–∑—ñ –ª–æ—Ç–æ—Å–∞	–¥–∑–µ–Ω|–π–æ–≥–∞|–ª—é–¥–∏–Ω–∞ –≤ –ø–æ–∑—ñ –ª–æ—Ç–æ—Å–∞|–º–µ–¥–∏—Ç–∞—Ü—ñ—è|–Ω—ñ—Ä–≤–∞–Ω–∞|–ø–æ–∑–∞ –ª–æ—Ç–æ—Å–∞|—Ä–µ–ª–∞–∫—Å|—Å—Ö—Ä–µ—â–µ–Ω—ñ –Ω–æ–≥–∏
üßô	–º–∞–≥	–≤—ñ–¥—å–º–∞|–ì–µ–Ω–¥–æ–ª—å—Ñ|–º–∞–≥|–º–∞–≥—ñ—è|–°—Ç–∞—Ä—ñ–∫-–•–æ—Ç–∞–±–∏—á|—á–∞–∫–ª—É–Ω|—á–∞–∫–ª—É–Ω–∫–∞|—á–∞—Ä—ñ–≤–Ω–∏–∫|—á–∞—Ä–æ–¥—ñ–π
üßö	—Ñ–µ—è	–∫–∞–∑–∫–∞|–∫—Ä–∏–ª–∞|–º–µ—Ç–µ–ª–∏–∫|–û–±–µ—Ä–æ–Ω|–ü–∞–∫|–¢–∏—Ç–∞–Ω—ñ—è|—Ñ–µ—è
üßõ	–≤–∞–º–ø—ñ—Ä	–≤–∞–º–ø—ñ—Ä|–î—Ä–∞–∫—É–ª–∞|–∫–æ—Å—Ç—é–º|–Ω–µ—á–∏—Å—Ç–∞ —Å–∏–ª–∞|–Ω–µ—á–∏—Å—Ç—å|–æ–ø–∏—Ä|–ø–æ–≥–∞–Ω—å|—É–ø–∏—Ä|–•–µ–ª–ª–æ–≤—ñ–Ω
üßú	–∫–∞–∑–∫–æ–≤–∞ –≤–æ–¥—è–Ω–∞ —ñ—Å—Ç–æ—Ç–∞	–≤–æ–¥—è–Ω–∞ —ñ—Å—Ç–æ—Ç–∞|–∂—ñ–Ω–∫–∞-—Ä—É—Å–∞–ª–∫–∞|–∫–∞–∑–∫–æ–≤–∞ –≤–æ–¥—è–Ω–∞ —ñ—Å—Ç–æ—Ç–∞|–ª—é–¥–∏–Ω–∞-—Ä—É—Å–∞–ª–∫–∞|–º–æ—Ä—Å—å–∫—ñ —Å—Ç–≤–æ—Ä—ñ–Ω–Ω—è|—Ä—É—Å–∞–ª–∫–∞|–°–∏—Ä–µ–Ω–∞|—Ñ–æ–ª—å–∫–ª–æ—Ä|—á–æ–ª–æ–≤—ñ–∫-—Ä—É—Å–∞–ª–∫–∞
üßù	–µ–ª—å—Ñ	–µ–ª—å—Ñ|–∫–∞–∑–∫–∞|–õ–µ–≥–æ–ª–∞—Å|–º–∞–≥—ñ—á–Ω–∏–π|—á–∞–∫–ª—É–Ω
üßû	–¥–∂–∏–Ω	–±–∞–∂–∞–Ω–Ω—è|–¥–∂–∏–Ω|–∫–∞–∑–∫–æ–≤–∞ –ª–∞–º–ø–∞|–º—ñ—Ñ—ñ—á–Ω–∏–π|–ø—Ä–∏–º—Ö–∞|—á–∞—Ä—ñ–≤–Ω–∞ –ª–∞–º–ø–∞
üßü	–∑–æ–º–±—ñ	–∂–∞—Ö|–∂–∏–≤–∏–π –º—Ä–µ—Ü—å|–∑–æ–±–º—ñ|–∑–æ–º–±—ñ|–º–æ–Ω—Å—Ç—Ä|–Ω–µ—á–∏—Å—Ç—å|—Ö–µ–ª–ª–æ—É—ñ–Ω
üß†	–º–æ–∑–æ–∫	—ñ–Ω—Ç–µ–ª–µ–∫—Ç|—ñ–Ω—Ç–µ–ª–µ–∫—Ç—É–∞–ª|–º—ñ–∑–∫–∏|–º–æ–∑–æ–∫|—Ä–æ–∑—É–º|—Ä–æ–∑—É–º–Ω–∞|—Ä–æ–∑—É–º–Ω–∏–π
üß°	–æ—Ä–∞–Ω–∂–µ–≤–µ —Å–µ—Ä—Ü–µ	–∫–æ—Ö–∞–Ω–Ω—è|–æ—Ä–∞–Ω–∂–µ–≤–µ —Å–µ—Ä—Ü–µ|–ø–æ–º–∞—Ä–∞–Ω—á–µ–≤–∏–π|—Å–µ—Ä—Ü–µ
üß¢	–±–µ–π—Å–±–æ–ª–∫–∞	–±–µ–π—Å–±–æ–ª–∫–∞|–±–µ–π—Å–±–æ–ª—å–Ω–∞ –∫–µ–ø–∫–∞|–∫–∞–ø–µ–ª—é—Ö|–∫–∞—à–∫–µ—Ç|–∫–µ–ø–∫–∞
üß£	—à–∞—Ä—Ñ	–∑–∏–º–∞|–∑–∏–º–Ω–æ|—à–∞–ª–∏–∫|—à–∞—Ä—Ñ|—à–∏—è
üß§	—Ä—É–∫–∞–≤–∏—á–∫–∏	—Ä—É–∫–∞|—Ä—É–∫–∞–≤–∏—Ü—è|—Ä—É–∫–∞–≤–∏—á–∫–∏
üß•	–ø–∞–ª—å—Ç–æ	–∑–∏–º–∞|–∑–∏–º–Ω–æ|–∫—É—Ä—Ç–∫–∞|–ø–∞–ª—å—Ç–æ|–ø—É—Ö–æ–≤–∏–∫|—Ö–æ–ª–æ–¥–Ω–æ
üß¶	—à–∫–∞—Ä–ø–µ—Ç–∫–∏	–ø–∞–Ω—á–æ—Ö–∏|—à–∫–∞—Ä–ø–µ—Ç–∫–∏
üßß	—á–µ—Ä–≤–æ–Ω–∏–π –∫–æ–Ω–≤–µ—Ä—Ç	–≥—Ä–æ—à—ñ|–∫–æ–Ω–≤–µ—Ä—Ç|–ª–∏—Å—Ç|–Ω–∞ —â–∞—Å—Ç—è|–ø–æ–¥–∞—Ä—É–Ω–æ–∫|—Ö—É–Ω–±–∞–æ|—á–µ—Ä–≤–æ–Ω–∏–π –∫–æ–Ω–≤–µ—Ä—Ç
üß®	–ø–µ—Ç–∞—Ä–¥–∞	–≤–∏–±—É—Ö|–≤–∏–±—É—Ö—ñ–≤–∫–∞|–≤–æ–≥–æ–Ω—å|–¥–∏–Ω–∞–º—ñ—Ç|—ñ—Å–∫—Ä–∏|—Å–∞–ª—é—Ç|—Ñ–µ—î—Ä–≤–µ—Ä–∫|—Ö–ª–æ–ø–∞–≤–∫–∞
üß©	–µ–ª–µ–º–µ–Ω—Ç –ø–∞–∑–ª–∞	–≥–æ–ª–æ–≤–æ–ª–æ–º–∫–∞|–µ–ª–µ–º–µ–Ω—Ç –ø–∞–∑–ª–∞|–∑‚Äô—î–¥–Ω–∞–Ω–Ω—è|–ø–∞–∑–ª|–ø—ñ–¥–∫–∞–∑–∫–∞|—Ä–æ–∑–≥–∞–¥–∫–∞|—Å–∫–¥–ª–∞–¥–∞–Ω–∫–∞|—á–∞—Å—Ç–∏–Ω–∞|—à–º–∞—Ç–æ–∫
üß™	–ø—Ä–æ–±—ñ—Ä–∫–∞	–¥–æ—Å–ª—ñ–¥|–µ–∫—Å–ø–µ—Ä–∏–º–µ–Ω—Ç|–ª–∞–±–æ—Ä–∞—Ç–æ—Ä—ñ—è|–Ω–∞—É–∫–∞|–ø—Ä–æ–±—ñ—Ä–∫–∞|—Ö—ñ–º—ñ–∫|—Ö—ñ–º—ñ—è
üß´	—á–∞—à–∫–∞ –ü–µ—Ç—Ä—ñ	–±–∞–∫—Ç–µ—Ä—ñ—ó|–±–∞–∫—Ç–µ—Ä—ñ—è|–±—ñ–æ–ª–æ–≥|–±—ñ–æ–ª–æ–≥—ñ—è|–∫—É–ª—å—Ç—É—Ä–∞|–ª–∞–±–æ—Ä–∞—Ç–æ—Ä—ñ—è|—á–∞—à–∫–∞ –ø–µ—Ç—Ä—ñ|—á–∞—à–∫–∞ –ü–µ—Ç—Ä—ñ
üß¨	–î–ù–ö	–±—ñ–æ–ª–æ–≥|–±—ñ–æ–ª–æ–≥—ñ—è|–≥–µ–Ω|–≥–µ–Ω–µ—Ç–∏–∫–∞|–¥–Ω–∫|–î–ù–ö|–µ–≤–æ–ª—é—Ü—ñ—è|–∂–∏—Ç—Ç—è|—Å–ø—ñ—Ä–∞–ª—å
üß≠	–∫–æ–º–ø–∞—Å	–∫–æ–º–ø–∞—Å|–º–∞–≥–Ω–µ—Ç–∏–∑–º|–º–∞–≥–Ω—ñ—Ç|–º–∞–≥–Ω—ñ—Ç–Ω–∏–π|–Ω–∞–≤—ñ–≥–∞—Ü—ñ—è|–Ω–∞–ø—Ä—è–º–æ–∫|–æ—Ä—ñ—î–Ω—Ç—É–≤–∞–Ω–Ω—è|—Å—Ç–æ—Ä–æ–Ω–∏ —Å–≤—ñ—Ç—É
üßÆ	—Ä–∞—Ö—ñ–≤–Ω–∏—Ü—è	–∞–±–∞–∫|–æ–±—á–∏—Å–ª–µ–Ω–Ω—è|–æ–±—á–∏—Å–ª—é–≤–∞–ª—å–Ω–∏–π –ø—Ä–∏—Å—Ç—Ä—ñ–π|—Ä–∞—Ö—ñ–≤–Ω–∏—Ü—è|—Ä–∞—Ö—É–≤–∞—Ç–∏
üßØ	–≤–æ–≥–Ω–µ–≥–∞—Å–Ω–∏–∫	–≤–æ–≥–Ω–µ–≥–∞—Å–Ω–∏–∫|–≤–æ–≥–æ–Ω—å|–≥–∞—Å–∏—Ç–∏|–ø–æ–∂–µ–∂–∞|—Ç—É—à–∏—Ç–∏|—Ç—É—à—ñ–Ω–Ω—è
üß∞	—Å–∫—Ä–∏–Ω—è –¥–ª—è —ñ–Ω—Å—Ç—Ä—É–º–µ–Ω—Ç—ñ–≤	—ñ–Ω—Å—Ç—Ä—É–º–µ–Ω—Ç|—ñ–Ω—Å—Ç—Ä—É–º–µ–Ω—Ç–∏|–∫–æ—Ä–æ–±–∫–∞|–º–µ—Ö–∞–Ω—ñ–∫|–º–µ—Ö–∞–Ω—ñ–∫–∞|–Ω–∞–±—ñ—Ä —ñ–Ω—Å—Ç—Ä—É–º–µ–Ω—Ç—ñ–≤|—Å–∫—Ä–∏–Ω—è|—Å–∫—Ä–∏–Ω—è –¥–ª—è —ñ–Ω—Å—Ç—Ä—É–º–µ–Ω—Ç—ñ–≤|—Å–∫—Ä–∏–Ω—è –∑ —ñ–Ω—Å—Ç—Ä—É–º–µ–Ω—Ç–∞–º–∏|—á–µ—Ä–≤–æ–Ω–∞ —Å–∫—Ä–∏–Ω—è
üß±	—Ü–µ–≥–ª–∞	–±—É–¥—ñ–≤–µ–ª—å–Ω–∏–π —Ä–æ–∑—á–∏–Ω|–≥–ª–∏–Ω–∞|—Ä–æ–∑—á–∏–Ω|—Å—Ç—ñ–Ω–∞|—Ü–µ–≥–ª–∞|—Ü–µ–≥–ª–∏–Ω–∞|—Ü–µ–≥–ª–∏–Ω–∏
üß≤	–º–∞–≥–Ω—ñ—Ç	u-–ø–æ–¥—ñ–±–Ω–∏–π|–º–∞–≥–Ω–µ—Ç–∏–∑–º|–º–∞–≥–Ω—ñ—Ç|–ø—ñ–≤–Ω—ñ—á–Ω–∏–π-–ø—ñ–≤–¥–µ–Ω–Ω–∏–π|–ø—ñ–¥–∫–æ–≤–∞|–ø–æ–∑–∏—Ç–∏–≤–Ω–∏–π-–Ω–µ–≥–∞—Ç–∏–≤–Ω–∏–π|–ø—Ä–∏—Ç—è–≥–∞–Ω–Ω—è|–ø—Ä–∏—Ç—è–≥—É–≤–∞—Ç–∏|—Ç—è–∂—ñ–Ω–Ω—è
üß≥	–±–∞–≥–∞–∂	–±–∞–≥–∞–∂|–≤–∞–ª—ñ–∑–∞|–ø–∞–∫—É–≤–∞—Ç–∏|–ø–æ–¥–æ—Ä–æ–∂|—Ç–æ—Ä–±–∞ –Ω–∞ –∫–æ–ª—ñ—â–∞—Ç–∫–∞—Ö|—á–µ–º–æ–¥–∞–Ω
üß¥	–ª–æ—Å—å–π–æ–Ω	–±–∞–ª—å–∑–∞–º|–∑–≤–æ–ª–æ–∂—É–≤–∞—á|–∫—Ä–µ–º –≤—ñ–¥ –∑–∞—Å–º–∞–≥–∏|–ª–æ—Å—å–π–æ–Ω|–ø–ª—è—à–∫–∞ –ª–æ—Å—å–π–æ–Ω—É|—Å–æ–Ω—Ü–µ–∑–∞—Ö–∏—Å–Ω–∏–π –∫—Ä–µ–º|—à–∞–º–ø—É–Ω—å
üßµ	–Ω–∏—Ç–∫–∞	–≥–æ–ª–∫–∞|–∂–∏–ª–∫–∞|–∫–æ—Ç—É—à–∫–∞|–Ω–∏—Ç–∫–∞|–ø—Ä—è–∂–∞|—à–∏—Ç—Ç—è|—à–ø—É–ª—å–∫–∞
üß∂	–ø—Ä—è–∂–∞	–≤‚Äô—è–∑–∞–Ω–Ω—è|–∫–ª—É–±–æ–∫|–º–æ—Ç–æ–∫|–º–æ—Ç—É–∑–∫–∞|–Ω–∏—Ç–∫–∞|–Ω–∏—Ç–∫–∏|–ø—Ä—è–¥–∏–≤–æ|–ø—Ä—è–∂–∞
üß∑	–∞–Ω–≥–ª—ñ–π—Å—å–∫–∞ —à–ø–∏–ª—å–∫–∞	–∞–Ω–≥–ª—ñ–π—Å—å–∫–∞ —à–ø–∏–ª—å–∫–∞|–±—É–ª–∞–≤–∫–∞|–≤—ñ–¥ –Ω–∞–≤—Ä–æ–∫—ñ–≤|–ø–∞–Ω–∫-—Ä–æ–∫|—à–ø–∏–ª—å–∫–∞
üß∏	–≤–µ–¥–º–µ–¥–∏–∫	–≤–µ–¥–º–µ–¥–∏–∫|–≤–µ–¥–º–µ–¥–∏–∫ —Ç–µ–¥–¥—ñ|—ñ–≥—Ä–∞—à–∫–∞|–º‚Äô—è–∫–∞ —ñ–≥—Ä–∞—à–∫–∞|–ø–ª—é—à|–ø–ª—é—à–µ–≤–∞ —ñ–≥—Ä–∞—à–∫–∞|–ø–ª—é—à–µ–≤–∏–π –≤–µ–¥–º–µ–¥–∏–∫
üßπ	–º—ñ—Ç–ª–∞	–≤—ñ–¥—å–º–∞|–≤—ñ–Ω–∏–∫|–∑–∞–º—ñ—Ç–∞–Ω–Ω—è|–º—ñ—Ç–ª–∞|–ø—ñ–¥–º—ñ—Ç–∞—Ç–∏|–ø—Ä–∏–±–∏—Ä–∞–Ω–Ω—è|–ø—Ä–∏–±–∏—Ä–∞—Ç–∏
üß∫	–∫–æ—à–∏–∫	–±—ñ–ª–∏–∑–Ω–∞|–∫–æ—Ä–∑–∏–Ω–∞|–∫–æ—à–∏–∫|–ø—ñ–∫–Ω—ñ–∫|–ø—Ä–∞–Ω–Ω—è|—É—Ä–æ–∂–∞–π|—Ñ–µ—Ä–º–∞
üßª	—Ä—É–ª–æ–Ω –ø–∞–ø–µ—Ä—É	–ø–∞–ø–µ—Ä–æ–≤—ñ —Ä—É—à–Ω–∏–∫–∏|–ø–∞–ø—ñ—Ä|—Ä—É–ª–æ–Ω –ø–∞–ø–µ—Ä—É|—Ç—É–∞–ª–µ—Ç|—Ç—É–∞–ª–µ—Ç–Ω–∏–π –ø–∞–ø—ñ—Ä
üßº	–º–∏–ª–æ	–±—Ä—É—Å–æ–∫|–±—É–ª—å–±–∞—à–∫–∏|–≤–∞–Ω–Ω–∞|–∫—É–ø–∞–Ω–Ω—è|–∫—É–ø–∞—Ç–∏—Å—è|–º–∏–ª–æ|–º–∏–ª—å–Ω–∏—Ü—è|–º–∏—Ç–∏—Å—è|–º–∏—Ç—Ç—è|—Ç—É–∞–ª–µ—Ç–Ω–µ –º–∏–ª–æ|—á–∏—Å—Ç–∏–π|—á–∏—Å—Ç–∏—Ç–∏|—à–∫—ñ—Ä–∞
üßΩ	–≥—É–±–∫–∞	–≥—É–±–∫–∞|–º–æ—á–∞–ª–∫–∞|–ø–æ–≥–ª–∏–Ω–∞–Ω–Ω—è|–ø–æ–≥–ª–∏–Ω–∞—Ç–∏|–ø–æ—Ä–∏|–ø–æ—Ä–∏—Å—Ç–∏–π|–ø–æ—Ä–æ–ª–æ–Ω|–ø—Ä–∏–±–∏—Ä–∞–Ω–Ω—è|—á–∏—Å—Ç–∏—Ç–∏
üßæ	–∫–≤–∏—Ç–∞–Ω—Ü—ñ—è	–±—É—Ö–≥–∞–ª—Ç–µ—Ä—ñ—è|–¥–æ–∫–∞–∑|–¥–æ–∫—É–º–µ–Ω—Ç|—ñ–Ω–≤–æ–π—Å|–∫–≤–∏—Ç–∞–Ω—Ü—ñ—è|—Ä–∞—Ö—É–Ω–æ–∫|—Ä–∞—Ö—É–Ω–æ–∫-—Ñ–∞–∫—Ç—É—Ä–∞|—Ñ–∞–∫—Ç—É—Ä–∞|—á–µ–∫
üßø	–û–∫–æ –§–∞—Ç—ñ–º–∏	–∞–º—É–ª–µ—Ç|–∞–º—É–ª–µ—Ç –≤—ñ–¥ –≤—Ä–æ–∫—ñ–≤|–Ω–∞–≤—Ä–æ—á–∏—Ç–∏|–Ω–∞–∑–∞—Ä|–Ω–∞–º–∏—Å—Ç–∏–Ω–∞|–æ–±–µ—Ä—ñ–≥|–û–∫–æ –§–∞—Ç—ñ–º–∏|–ø—Ä–∏—Å—Ç—Ä—ñ—Ç|—Å–∏–Ω—ñ–π|—Ç–∞–ª—ñ—Å–º–∞–Ω|—à–∞—Ä–º
ü©∞	–±–∞–ª–µ—Ç–Ω—ñ —Ç—É—Ñ–ª—ñ	–±–∞–ª–µ—Ç|–±–∞–ª–µ—Ç–Ω—ñ —Ç—É—Ñ–ª—ñ|–≤–∑—É—Ç—Ç—è|–ø—É–∞–Ω—Ç–∏|—Ç–∞–Ω–µ—Ü—å|—Ç–∞–Ω—Ü—é–≤–∞–ª—å–Ω—ñ
ü©±	—Å—É—Ü—ñ–ª—å–Ω–∏–π –∫—É–ø–∞–ª—å–Ω–∏–∫	–∑–∞–∫—Ä–∏—Ç–∏–π|–∫–æ—Å—Ç—é–º –¥–ª—è –ø–ª–∞–≤–∞–Ω–Ω—è|–∫—É–ø–∞–ª—å–Ω–∏–π –∫–æ—Å—Ç—é–º|–ø–ª–∞–≤–∞—Ç–∏|—Å—É—Ü—ñ–ª—å–Ω–∏–π –∫—É–ø–∞–ª—å–Ω–∏–∫
ü©≤	–ø–ª–∞–≤–∫–∏	–±—Ä–∏—Ñ–∏|–∫—É–ø–∞–ª—å–Ω–∏–∫|–æ–¥–∏–Ω–∞—Ä–Ω–∏–π|–ø–ª–∞–≤–∫–∏|—Å–ø—ñ–¥–Ω—î|—Ç—Ä—É—Å–∏
ü©≥	—à–æ—Ä—Ç–∏	–∫—É–ø–∞–ª—å–Ω–∏–∫|–ø–ª–∞–≤–∫–∏|—Å–ø—ñ–¥–Ω—î|—Ç—Ä—É—Å–∏|—à–æ—Ä—Ç–∏
ü©¥	–≤‚Äô—î—Ç–Ω–∞–º–∫–∏	–≤‚Äô—î—Ç–Ω–∞–º–∫–∏|–≤–∑—É—Ç—Ç—è|–¥–∑–æ—Ä—ñ|–º–æ—Ä–µ|–ø—ñ—Å–æ–∫|–ø–ª—è–∂|–ø–ª—è–∂–Ω—ñ —Å–∞–Ω–¥–∞–ª—ñ|—Å–∞–Ω–¥–∞–ª—ñ|—à–ª—å–æ–ø–∞–Ω—Ü—ñ
ü©µ	–±–ª–∞–∫–∏—Ç–Ω–µ —Å–µ—Ä—Ü–µ	–±–ª–∞–∫–∏—Ç–Ω–µ —Å–µ—Ä—Ü–µ|–±–ª–∞–∫–∏—Ç–Ω–∏–π|–µ–º–æ—Ü—ñ—è|–ª—é–±–ª—é|–ª—é–±–æ–≤|–º–∏–ª–∏–π|–æ—Å–æ–±–ª–∏–≤–∏–π|–ø–æ–¥–æ–±–∞—Ç–∏—Å—è|—Å–≤—ñ—Ç–ª–æ-—Å–∏–Ω—ñ–π|—Å–µ—Ä—Ü–µ|—Å–∏–Ω—ñ–π|—Ü—ñ–∞–Ω–æ–≤–∏–π
ü©∂	—Å—ñ—Ä–µ —Å–µ—Ä—Ü–µ	–≥—Ä–∞—Ñ—ñ—Ç–æ–≤–∏–π|–µ–º–æ—Ü—ñ—è|–ª—é–±–ª—é|–ª—é–±–æ–≤|–æ—Å–æ–±–ª–∏–≤–∏–π|—Å–µ—Ä—Ü–µ|—Å—ñ—Ä–µ —Å–µ—Ä—Ü–µ|—Å—ñ—Ä–∏–π|—Å—Ä—ñ–±–Ω–∏–π
ü©∑	—Ä–æ–∂–µ–≤–µ —Å–µ—Ä—Ü–µ	–¥–æ–±—Ä–∏–π|–µ–º–æ—Ü—ñ—è|–ª—é–±–ª—é|–ª—é–±–æ–≤|–º–∏–ª–∏–π|–æ—Å–æ–±–ª–∏–≤–∏–π|–ø–æ–¥–æ–±–∞—î—Ç—å—Å—è|—Ä–æ–∂–µ–≤–µ —Å–µ—Ä—Ü–µ|—Ä–æ–∂–µ–≤–∏–π|—Å–µ—Ä—Ü–µ|—Å–æ–ª–æ–¥–∫–∏–π|—á–∞—Ä—ñ–≤–Ω–∏–π
ü©∏	–∫—Ä–∞–ø–ª—è –∫—Ä–æ–≤—ñ	–∞–Ω–∞–ª—ñ–∑ –∫—Ä–æ–≤—ñ|–¥–æ–Ω–æ—Ä—Å—Ç–≤–æ –∫—Ä–æ–≤—ñ|–∫—Ä–∞–ø–ª—è –∫—Ä–æ–≤—ñ|–∫—Ä–∏—Ç–∏—á–Ω—ñ –¥–Ω—ñ|–∫—Ä–æ–≤|–∫—Ä–æ–≤–æ—Ç–µ—á–∞|–º–µ–¥–∏—Ü–∏–Ω–∞|–º–µ–Ω—Å—Ç—Ä—É–∞—Ü—ñ—è|–º—ñ—Å—è—á–Ω–µ|—Å—Ç—ñ–∫–∞—Ç–∏ –∫—Ä–æ–≤ º—é|—Ç—Ä–∞–≤–º–∞
ü©π	–ø–ª–∞—Å—Ç–∏—Ä	–±–∞–Ω–¥–∞–∂|–∫–ª–µ–π–∫–∞ —Å–º—É–∂–∫–∞|–ª–µ–π–∫–æ–ø–ª–∞—Å—Ç–∏—Ä|–Ω–∞–∫–ª–µ–π–∫–∞|–Ω–∞–ª—ñ–ø–∫–∞|–ø–ª–∞—Å—Ç–∏—Ä
ü©∫	—Å—Ç–µ—Ç–æ—Å–∫–æ–ø	–≤–∏—Å–ª—É—Ö—É–≤–∞—Ç–∏ —Å–µ—Ä—Ü–µ|–ª—ñ–∫–∞—Ä|–º–µ–¥–∏—Ü–∏–Ω–∞|—Å–µ—Ä—Ü–µ|—Å–ª—É—Ö–∞—Ç–∏|—Å—Ç–µ—Ç–æ—Å–∫–æ–ø
ü©ª	—Ä–µ–Ω—Ç–≥–µ–Ω	–∫—ñ—Å—Ç–∫–∏|–ª—ñ–∫–∞—Ä|–º–µ–¥–∏—Ü–∏–Ω–∞|—Ä–µ–Ω—Ç–≥–µ–Ω|—Å–∫–µ–ª–µ—Ç
ü©º	–º–∏–ª–∏—Ü—è	–≤—Ç—Ä–∞—Ç–∞ –¥—ñ—î–∑–¥–∞—Ç–Ω–æ—Å—Ç—ñ|–¥–æ–ø–æ–º–æ–≥–∞|–∑–∞—Å—ñ–± –≤—ñ–¥–Ω–æ–≤–ª–µ–Ω–Ω—è –∑–¥–∞—Ç–Ω–æ—Å—Ç—ñ —Ä—É—Ö–∞—Ç–∏—Å—è|—ñ–Ω–≤–∞–ª—ñ–¥–Ω—ñ—Å—Ç—å|–∫–æ—Å—Ç—É—Ä|–º–∏–ª–∏—Ü—è|–ø–æ—Ä–∞–Ω–µ–Ω–∏–π|—Ç—Ä–∞–≤–º–∞|—Ü—ñ–ø–æ–∫
ü™Ä	–π–æ-–π–æ	–±–æ–≤—Ç–∞—Ç–∏—Å—è|—ñ–≥—Ä–∞—à–∫–∞|–π–æ-–π–æ|–∫—Ä—É—Ç–∏—Ç–∏—Å—è|–º–µ—Ç–ª—è—Ç–∏—Å—è|—Ç–µ–ª—ñ–ø–∞—Ç–∏—Å—è|—Ö–∏–ª–∏—Ç–∞—Ç–∏—Å—è
ü™Å	–ø–æ–≤—ñ—Ç—Ä—è–Ω–∏–π –∑–º—ñ–π	–≤–∏—Ç–∞—Ç–∏|–ª–∏–Ω—É—Ç–∏|–ª—ñ—Ç–∞—Ç–∏|–ª—ñ—Ç—É–Ω|–ø—ñ–¥–Ω—ñ–º–∞—Ç–∏—Å—è|–ø–æ–≤—ñ—Ç—Ä—è–Ω–∏–π –∑–º—ñ–π|—à–∏—Ä—è—Ç–∏
ü™Ç	–ø–∞—Ä–∞—à—É—Ç	–∫–∞–π—Ç|–ø–∞—Ä–∞–ø–ª–∞–Ω|–ø–∞—Ä–∞–ø–ª–∞–Ω–µ—Ä–∏–∑–º|–ø–∞—Ä–∞—Ñ–æ–π–ª|–ø–∞—Ä–∞—à—É—Ç|–ø–∞—Ä–∞—à—É—Ç-–∫—Ä–∏–ª–æ|—Å–ø–æ—Ä—Ç|—Å—Ç—Ä–∏–±–∫–∏ –∑ –ø–∞—Ä–∞—à—É—Ç–æ–º|—Å—Ç—Ä–∏–±–æ–∫
ü™É	–±—É–º–µ—Ä–∞–Ω–≥	–∞–±–æ—Ä–∏–≥–µ–Ω–∏|–∞–≤—Å—Ç—Ä–∞–ª—ñ—è|–ê–≤—Å—Ç—Ä–∞–ª—ñ—è|–±—É–º–µ—Ä–∞–Ω–≥|–≤—ñ–¥–¥–∞—á–∞|–∑–±—Ä–æ—è|–ø–æ–≤–µ—Ä–Ω–µ–Ω–Ω—è|–ø–æ–ª—é–≤–∞–Ω–Ω—è|—Ä–∏–∫–æ—à–µ—Ç
ü™Ñ	—á–∞—Ä—ñ–≤–Ω–∞ –ø–∞–ª–∏—á–∫–∞	–∞–±—Ä–∞–∫–∞–¥–∞–±—Ä–∞|—ñ–ª—é–∑—ñ—ó|–º–∞–≥—ñ—á–Ω–µ —à–æ—É|–º–∞–≥—ñ—è|—Ñ–æ–∫—É—Å–∏|—á–∞–∫–ª—É–Ω|—á–∞–∫–ª—É–Ω–∫–∞|—á–∞—Ä—ñ–≤–Ω–∏–∫
ü™Ö	–ø—ñ–Ω—å—è—Ç–∞	–≤–µ—á—ñ—Ä–∫–∞|—ñ–≥—Ä–∞—à–∫–∞|–º–µ–∫—Å–∏–∫–∞|–ø–∞–ª–∏—Ü—è|–ø—ñ–Ω—å—è—Ç–∞|—Å–≤—è—Ç–∫—É–≤–∞–Ω–Ω—è|—Å–≤—è—Ç–æ|—Ü—É–∫–µ—Ä–∫–∏
ü™Ü	–ª—è–ª—å–∫–∏-–º–∞—Ç—Ä—å–æ—à–∫–∏	–¥–µ—Ä–µ–≤‚Äô—è–Ω–∞ —ñ–≥—Ä–∞—à–∫–∞|–¥–µ—Ä–µ–≤‚Äô—è–Ω–∞ –ª—è–ª—å–∫–∞|–ª—è–ª—å–∫–∞|–ª—è–ª—å–∫–∞ –≤ –ª—è–ª—å—Ü—ñ|–ª—è–ª—å–∫–∏-–º–∞—Ç—Ä—å–æ—à–∫–∏|–º–∞—Ç—Ä—å–æ—à–∫–∞|–Ω–∞—Ä–æ–¥–Ω–∞ —ñ–≥—Ä–∞—à–∫–∞|—Ä–æ—Å—ñ—è
ü™á	–º–∞—Ä–∞–∫–∞—Å	–≤–µ—á—ñ—Ä–∫–∞|—ñ–Ω—Å—Ç—Ä—É–º–µ–Ω—Ç|–º–∞—Ä–∞–∫–∞—Å|–º—É–∑–∏–∫–∞|—Ç–∞–Ω–µ—Ü—å|—É–¥–∞—Ä–Ω—ñ —ñ–Ω—Å—Ç—Ä—É–º–µ–Ω—Ç–∏|—á–∞-—á–∞-—á–∞
ü™à	—Ñ–ª–µ–π—Ç–∞	–±–ª–æ–∫—Ñ–ª–µ–π—Ç–∞|–¥–µ—Ä–µ–≤ º—è–Ω—ñ –¥—É—Ö–æ–≤—ñ —ñ–Ω—Å—Ç—Ä—É–º–µ–Ω—Ç–∏|–¥—É–¥–∫–∞|—ñ–Ω—Å—Ç—Ä—É–º–µ–Ω—Ç|–º—É–∑–∏–∫–∞|—Å–æ–ø—ñ–ª–∫–∞|—Ñ–ª–µ–π—Ç–∞
ü™â	–∞—Ä—Ñ–∞	–∞–º—É—Ä|—ñ–Ω—Å—Ç—Ä—É–º–µ–Ω—Ç|–∫—É–ø—ñ–¥–æ–Ω|–ª—é–±–æ–≤|–º—É–∑–∏–∫–∞|–æ—Ä–∫–µ—Å—Ç—Ä
ü™è	–ª–æ–ø–∞—Ç–∞	–∑–∞—Å—Ç—É–ø|–∫–æ–ø–∞—Ç–∏|–º–æ–≥–∏–ª–∞|–ø–æ—Ö–æ–≤–∞–Ω–Ω—è|—Ä–æ—Å–ª–∏–Ω–∞|—Å–∞–¥|—Å–Ω—ñ–≥|—Å–æ–≤–æ–∫|—è–º–∞
ü™ê	–ø–ª–∞–Ω–µ—Ç–∞ –∑ –∫—ñ–ª—å—Ü–µ–º	–ø–ª–∞–Ω–µ—Ç–∞ –∑ –∫—ñ–ª—å—Ü–µ–º|—Å–∞—Ç—É—Ä–Ω|–°–∞—Ç—É—Ä–Ω
ü™ë	—Å—Ç—ñ–ª–µ—Ü—å	–∫—Ä—ñ—Å–ª–æ|–º–µ–±–ª—ñ|—Å–∏–¥—ñ–Ω–Ω—è|—Å–∏–¥—ñ—Ç–∏|—Å—Ç—ñ–ª–µ—Ü—å
ü™í	–±—Ä–∏—Ç–≤–∞	–±—Ä–∏—Ç–≤–∞|–≥–æ–ª–∏—Ç–∏|–≥–æ–ª–∏—Ç–∏—Å—è|–≥–æ—Å—Ç—Ä–∞|–ª–µ–∑–æ|–Ω–µ–±–µ–∑–ø–µ—á–Ω–∞
ü™ì	—Å–æ–∫–∏—Ä–∞	–¥–µ—Ä–µ–≤–∏–Ω–∞|–¥—Ä–æ–≤–∞|–∫–æ–ª–æ—Ç–∏|—Ä–æ–∑–∫–æ–ª—é–≤–∞—Ç–∏|—Ä—É–±–∞—Ç–∏|—Å–æ–∫–∏—Ä–∞|—Ç–µ—Å–∞—Ç–∏|—Ç—è—Ç–∏
ü™î	–∫–∞–≥–∞–Ω–µ—Ü—å	–±–ª–∏–º–∞–≤–∫–∞|–∫–∞–≥–∞–Ω–µ—Ü—å|–ª–∞–º–ø–∞|–ª–∞–º–ø–∞–¥–∫–∞|–º–∏–≥—É–Ω–µ—Ü—å|–æ–ª—ñ–π–Ω–∞
ü™ï	–±–∞–Ω–¥–∂–æ	–±–∞–Ω–¥–∂–æ|—ñ–Ω—Å—Ç—Ä—É–º–µ–Ω—Ç|–º—É–∑–∏—á–Ω–∏–π|—Å—Ç—Ä—É–Ω–Ω–∏–π|—â–∏–ø–∫–æ–≤–∏–π
ü™ñ	–≤—ñ–π—Å—å–∫–æ–≤–∏–π —à–æ–ª–æ–º	–∞—Ä–º—ñ—è|–≤—ñ–π—Å—å–∫–æ–≤–∏–π|–≤–æ—ó–Ω|–∫–∞—Å–∫–∞|—Å–æ–ª–¥–∞—Ç|—Å–æ–ª–¥–∞—Ç—Å—å–∫–∏–π|—à–æ–ª–æ–º
ü™ó	–∞–∫–æ—Ä–¥–µ–æ–Ω	–∞–∫–æ—Ä–¥–µ–æ–Ω|–±–∞—è–Ω|–≥–∞—Ä–º–æ–Ω—ñ–∫–∞|—ñ–Ω—Å—Ç—Ä—É–º–µ–Ω—Ç|–∫–ª–∞–≤—ñ—à—ñ|–∫–æ–Ω—Ü–µ—Ä—Ç–∏–Ω–∞|–º—É–∑–∏–∫–∞
ü™ò	—Ü–∏–ª—ñ–Ω–¥—Ä–∏—á–Ω–∏–π –±–∞—Ä–∞–±–∞–Ω	–±–∞—Ä–∞–±–∞–Ω|—ñ–Ω—Å—Ç—Ä—É–º–µ–Ω—Ç|–∫–æ–Ω“ë–∞|–º—É–∑–∏–∫–∞|—Ä–∏—Ç–º|—É–¥–∞—Ä–Ω—ñ|—Ü–∏–ª—ñ–Ω–¥—Ä–∏—á–Ω–∏–π –±–∞—Ä–∞–±–∞–Ω
ü™ô	–º–æ–Ω–µ—Ç–∞	–±–∞–≥–∞—Ç—Å—Ç–≤–æ|–≥—Ä–æ—à—ñ|–¥–æ–ª–∞—Ä|—î–≤—Ä–æ|–∑–æ–ª–æ—Ç–æ|–º–µ—Ç–∞–ª|–º–æ–Ω–µ—Ç–∞|—Å–∫–∞—Ä–±|—Å—Ä—ñ–±–ª–æ
ü™ö	—Ç–µ—Å–ª—è—Ä—Å—å–∫–∞ –ø–∏–ª–∞	–¥–µ—Ä–µ–≤–∏–Ω–∞|—ñ–Ω—Å—Ç—Ä—É–º–µ–Ω—Ç|–ø–∏–ª–∞|–ø–∏–ª–∫–∞|–ø–∏–ª—è—Ç–∏|—Ä—ñ–∑–∞—Ç–∏|—Ä—É—á–Ω–∞ –ø–∏–ª–∫–∞|—Ç–µ—Å–ª—è|—Ç–µ—Å–ª—è—Ä—Å—å–∫–∞ –ø–∏–ª–∞
ü™õ	–≤–∏–∫—Ä—É—Ç–∫–∞	–≤–∏–∫—Ä—É—Ç–∫–∞|–≥–≤–∏–Ω—Ç|—ñ–Ω—Å—Ç—Ä—É–º–µ–Ω—Ç|–º–∞–π—Å—Ç–µ—Ä–Ω—è|–ø–ª–∞—Å–∫–∞ –≤–∏–∫—Ä—É—Ç–∫–∞|—Ä–µ–º–æ–Ω—Ç|—à–ª—ñ—Ü
ü™ú	–¥—Ä–∞–±–∏–Ω–∞	–≤–∏–ª—ñ–∑—Ç–∏|–¥—Ä–∞–±–∏–Ω–∞|–ª—ñ–∑—Ç–∏|–ø–µ—Ä–µ–∫–ª–∞–¥–∏–Ω–∞|–ø—Ä–∏—Å—Ç–∞–≤–Ω–∞ –¥—Ä–∞–±–∏–Ω–∞|—Å—Ö–æ–¥–∏–Ω–∫–∞|—â–∞–±–µ–ª—å
ü™ù	–≥–∞—á–æ–∫	–≤—É–¥–∫–∞|–≥–∞–∫|–≥–∞—á–æ–∫|–∫–æ–º–µ—Ä—Ü—ñ–π–Ω–∏–π –∞—Ä–≥—É–º–µ–Ω—Ç|–∫—Ä–∏–≤–∞|–∫—Ä—ñ–ø–ª–µ–Ω–Ω—è|–ø—ñ–π–º–∞—Ç–∏|–ø—Ä–∏–Ω–∞–¥–∞|—Ä–∏–±–æ–ª–æ–≤–ª—è
ü™û	–¥–∑–µ—Ä–∫–∞–ª–æ	–≤—ñ–¥–±–∏–≤–∞—á|–≤—ñ–¥–æ–±—Ä–∞–∂–µ–Ω–Ω—è|–¥–µ–∫–æ—Ä|–¥–∑–µ—Ä–∫–∞–ª–æ|—ñ–Ω—Ç–µ—Ä º—î—Ä|–∫—Ä–∞—Å–∞|–º–∞–∫—ñ—è–∂|—Ä–µ—Ñ–ª–µ–∫—Ç–æ—Ä
ü™ü	–≤—ñ–∫–Ω–æ	–±—É–¥–∏–Ω–æ–∫|–≤—ñ–¥—á–∏–Ω–∏—Ç–∏|–≤—ñ–∫–Ω–æ|–∫—Ä–∞—î–≤–∏–¥|–ø—Ä–æ–∑–æ—Ä–µ|—Ä–∞–º–∞|—Å–≤—ñ–∂–µ –ø–æ–≤—ñ—Ç—Ä—è|—Å–∫–ª–æ
ü™†	–≤–∞–Ω—Ç—É–∑	–≤–∞–Ω—Ç—É–∑|–≥—É–º–æ–≤–∞ –ø—Ä–∏—Å–æ—Å–∫–∞|–∑–∞–∫—É–ø–æ—Ä–µ–Ω–Ω—è|–ø—Ä–æ—á–∏—â–µ–Ω–Ω—è|—Å–∞–Ω—Ç–µ—Ö–Ω—ñ–∫|—Ç—Ä—É–±–∏|—Ç—É–∞–ª–µ—Ç
ü™°	—à–≤–∞—Ü—å–∫–∞ –≥–æ–ª–∫–∞	–≤–∏—à–∏–≤–∞–Ω–Ω—è|–≤—É—à–∫–æ|–≥–æ–ª–∫–∞|–≥–æ–ª–∫–∞ –∑ –Ω–∏—Ç–∫–æ—é|–∫—Ä–∞–≤–µ—Ü—Ç–≤–æ|–Ω–∏—Ç–∫–∞|–Ω–∏—Ç–∫–∞ –∑ –≥–æ–ª–∫–æ—é|—Å—Ç—ñ–±–∫–∏|—à–≤–∞—Ü—å–∫–∞ –≥–æ–ª–∫–∞|—à–≤–∏|—à–∏—Ç—Ç—è
ü™¢	–≤—É–∑–æ–ª	–≤—É–∑–æ–ª|–∫–∞–Ω–∞—Ç|–º–æ—Ä—Å—å–∫–∏–π –≤—É–∑–æ–ª|–º–æ—Ç—É–∑–∫–∞|–ø–µ—Ç–ª—è|–ø–ª–µ—Ç–µ–Ω–Ω—è|–ø–ª–µ—Ç–∏–≤–æ|—Ç—Ä–æ—Å|—à–Ω—É—Ä–æ–∫
ü™£	–≤—ñ–¥—Ä–æ	–±–∞–∫|–≤—ñ–¥–µ—Ä—Ü–µ|–≤—ñ–¥—Ä–æ|—Ü–µ–±–µ—Ä–∫–æ|—á–∞–Ω|—à–∞–ø–ª–∏–∫
ü™§	–º–∏—à–æ–ª–æ–≤–∫–∞	–º–∏—à–æ–ª–æ–≤–∫–∞|–ø–∞—Å—Ç–∫–∞|–ø—Ä–∏–º–∞–Ω–∫–∞|—Å–∏–ª—å—Ü–µ|—Å–∏—Ä
ü™•	–∑—É–±–Ω–∞ —â—ñ—Ç–∫–∞	–≤–∞–Ω–Ω–∞ –∫—ñ–º–Ω–∞—Ç–∞|–≥—ñ–≥—ñ—î–Ω–∞|–∑—É–±–∏|–∑—É–±–Ω–∞|—Ç—É–∞–ª–µ—Ç|—á–∏—Å—Ç–∏—Ç–∏|—â—ñ—Ç–∫–∞
ü™¶	–Ω–∞–¥–≥—Ä–æ–±–æ–∫	–µ–ø—ñ—Ç–∞—Ñ—ñ—è|–∫–ª–∞–¥–æ–≤–∏—â–µ|–º–µ–º–æ—Ä—ñ–∞–ª|–º–µ—Ä—Ç–≤–∏–π|–º–æ–≥–∏–ª—å–Ω–∞ –ø–ª–∏—Ç–∞|–Ω–∞–¥–≥—Ä–æ–±–æ–∫|–ø–∞–º º—è—Ç–Ω–∏–∫|–ø–æ–∫—ñ–π–Ω–∏–∫|—Å–º–µ—Ä—Ç—å|—Ü–≤–∏–Ω—Ç–∞—Ä
ü™ß	–ø–ª–∞–∫–∞—Ç	–≥–∞—Å–ª–æ|–¥–µ–º–æ–Ω—Å—Ç—Ä–∞—Ü—ñ—è|–∑–Ω–∞–∫|–º—ñ—Ç–∏–Ω–≥|–ø—ñ–∫–µ—Ç|–ø–ª–∞–∫–∞—Ç|–ø—Ä–æ—Ç–µ—Å—Ç|—Ç–∞–±–ª–∏—á–∫–∞|—Ç—Ä–∞–Ω—Å–ø–∞—Ä–∞–Ω—Ç
ü™®	–∫–∞–º—ñ–Ω—å	–±—Ä–∏–ª–∞|–≤–∞–∂–∫–∏–π|–≤–∞–ª—É–Ω|–≥—ñ—Ä—Å—å–∫–∞ –ø–æ—Ä–æ–¥–∞|–∫–∞–º–µ–Ω—é–∫–∞|–∫–∞–º—ñ–Ω—å|–∫—Ä—É–≥–ª—è–∫|—Å–∫–µ–ª—è|—Ç–≤–µ—Ä–¥–∏–π
ü™©	–¥–∑–µ—Ä–∫–∞–ª—å–Ω–∞ –∫—É–ª—è	–±–ª–∏—Å–∫—É—á–∏–π|–≤–µ—á—ñ—Ä–∫–∞|–¥–∑–µ—Ä–∫–∞–ª—å–Ω–∞ –∫—É–ª—è|–¥–∏—Å–∫–æ|–¥–∏—Å–∫–æ-–∫—É–ª—è|–¥–∏—Å–∫–æ—Ç–µ–∫–∞|–∫—É–ª—è|—Ç–∞–Ω—Ü—ñ|—Ç–∞–Ω—Ü—é–≤–∞—Ç–∏
ü™™	–ø–æ—Å–≤—ñ–¥—á–µ–Ω–Ω—è	–≤–æ–¥—ñ–π—Å—å–∫–µ –ø–æ—Å–≤—ñ–¥—á–µ–Ω–Ω—è|–¥–æ–∫—É–º–µ–Ω—Ç|—ñ–¥–µ–Ω—Ç–∏—Ñ—ñ–∫–∞—Ü—ñ–π–Ω–∞ –∫–∞—Ä—Ç–∫–∞|—ñ–¥–µ–Ω—Ç–∏—Ñ—ñ–∫–∞—Ü—ñ–π–Ω–∏–π –¥–æ–∫—É–º–µ–Ω—Ç|–æ—Å–æ–±–æ–≤—ñ –¥–∞–Ω—ñ|–ø–æ—Å–≤—ñ–¥—á–µ–Ω–Ω—è|–ø–æ—Å–≤—ñ–¥—á–µ–Ω–Ω—è –æ—Å–æ–±–∏|–ø—Ä–æ–ø—É—Å–∫
ü™´	–Ω–∏–∑—å–∫–∏–π –∑–∞—Ä—è–¥ –±–∞—Ç–∞—Ä–µ—ó	–±–∞—Ç–∞—Ä–µ—è|–µ–ª–µ–∫—Ç—Ä–æ–Ω—ñ–∫–∞|–Ω–∏–∑—å–∫–∏–π –∑–∞—Ä—è–¥|–Ω–∏–∑—å–∫–∏–π –∑–∞—Ä—è–¥ –±–∞—Ç–∞—Ä–µ—ó|—Ä–æ–∑—Ä—è–¥–∂–µ–Ω–∞ –±–∞—Ç–∞—Ä–µ—è|—Ä–æ–∑—Ä—è–¥–∂–µ–Ω–∏–π|—Ä–æ–∑—Ä—è–¥–∂–µ–Ω–æ
ü™¨	—Ö–∞–º—Å–∞	–∞–º—É–ª–µ—Ç|–¥–æ–ª–æ–Ω—è|–∑–∞—Ö–∏—Å—Ç|–ú–∞—Ä—ñ—è|–ú—ñ—Ä º—è–º|–ø—Ä–æ–≤–∏–¥—ñ–Ω–Ω—è|—Ä—É–∫–∞|—É–¥–∞—á–∞|–§–∞—Ç—ñ–º–∞
ü™≠	—Å–∫–ª–∞–¥–∞–Ω–µ –≤—ñ—è–ª–æ	–æ—Ö–æ–ª–æ–¥–∂—É–≤–∞—Ç–∏|—Å–∫–ª–∞–¥–∞–Ω–µ –≤—ñ—è–ª–æ|—Å–æ—Ä–æ–º–∏—Ç–∏—Å—è|—Ç–∞–Ω—Ü—é–≤–∞—Ç–∏|—Ñ–ª—ñ—Ä—Ç—É–≤–∞—Ç–∏
ü™Æ	–≥—Ä–µ–±—ñ–Ω—å	–∞—Ñ—Ä–æ|–≤–æ–ª–æ—Å—Å—è|–≥—Ä–µ–±—ñ–Ω—å|—Ä–æ–∑—á—ñ—Å—É–≤–∞—Ç–∏
ü™Ø	–∫—Ö–∞–Ω–¥–∞	–≤—ñ—Ä–∞|–∫—Ö–∞–Ω–¥–∞|—Ä–µ–ª—ñ–≥—ñ—è|—Å–∏–∫—Ö|—Å–∏–∫—Ö—ñ–∑–º
ü™∞	–º—É—Ö–∞	–≥–Ω–∏–ª—å|–¥–∑–∏–∂—á–∞–Ω–Ω—è|–∫–æ–º–∞—Ö–∞|–∫—Ä–∏–ª–∞|–ª–∏—á–∏–Ω–∫–∞|–º—É—Ö–∞|—Ö–≤–æ—Ä–æ–±–∞|—à–∫—ñ–¥–Ω–∏–∫
ü™±	—Ö—Ä–æ–±–∞–∫	–¥–æ—â–æ–≤–∏–π —Ö—Ä–æ–±–∞–∫|–¥–æ—â–æ–≤–∏–π —á–µ—Ä–≤ º—è–∫|–∑–µ–º–ª—è–Ω–∏–π —á–µ—Ä–≤ º—è–∫|–∫—ñ–ª—å—á–∞—Å—Ç–∏–π —á–µ—Ä–≤|–Ω–∞–∂–∏–≤–∫–∞|–ø–∞—Ä–∞–∑–∏—Ç|—Ç–≤–∞—Ä–∏–Ω–∞|—Ö—Ä–æ–±–∞–∫|—á–µ—Ä–≤ º—è–∫
ü™≤	–∂—É–∫	–±—Ä–æ–Ω–∑—ñ–≤–∫–∞|–∂—É–∫|–∂—É—á–æ–∫|–∫–æ–º–∞—Ö–∞|–∫—É–∑–∫–∞|–∫—É–∑—å–∫–∞|—Ç–≤–∞—Ä–∏–Ω–∞
ü™≥	—Ç–∞—Ä–≥–∞–Ω	–∫–æ–º–∞—Ö–∞|–Ω–µ–ø—Ä–æ—Ö–∞–Ω–∏–π –≥—ñ—Å—Ç—å|–ø–∞—Ä–∞–∑–∏—Ç|–ø—Ä—É—Å–∞–∫|–ø—Ä—É—Å–∞–∫ —Ä—É–¥–∏–π|—Ç–∞—Ä–≥–∞–Ω|—Ç–≤–∞—Ä–∏–Ω–∞|—à–∫—ñ–¥–Ω–∏–∫
ü™¥	—Ä–æ—Å–ª–∏–Ω–∞ –≤ –≥–æ—Ä—â–∏–∫—É	–≤–∞–∑–æ–Ω|–≤–∏—Ä–æ—â—É–≤–∞—Ç–∏|–≥–æ—Ä—â–∏–∫|–¥–µ–∫–æ—Ä|–¥–æ–≥–ª—è–¥|–¥–æ–º–∞—à–Ω—è|–∫—ñ–º–Ω–∞—Ç–Ω–∞|—Ä–æ—Å–ª–∏–Ω–∞
ü™µ	–¥–µ—Ä–µ–≤–∏–Ω–∞	–¥–µ—Ä–µ–≤–∏–Ω–∞|–¥–µ—Ä–µ–≤–æ|–∫–æ–ª–æ–¥–∞|–ª—ñ—Å–æ–º–∞—Ç–µ—Ä—ñ–∞–ª|–ø–µ–Ω—å|–ø–µ–Ω—å–æ–∫|—Ä—ñ—á–Ω—ñ –∫—ñ–ª—å—Ü—è|—Ä—É–±–∞—Ç–∏
ü™∂	–ø—ñ—Ä‚Äô—ó–Ω–∞	–Ω–µ–≤–∞–≥–æ–º–∞|–æ–ø–µ—Ä–µ–Ω–Ω—è|–ø–µ—Ä–æ|–ø—ñ—Ä‚Äô—ó–Ω–∞|–ø—ñ—Ä‚Äô—è|–ø–æ–ª—ñ—Ç|–ø—Ç–∞—Ö
ü™∑	–ª–æ—Ç–æ—Å	–±–µ–∑—Ç—É—Ä–±–æ—Ç–Ω—ñ—Å—Ç—å|–±—É–¥–¥–∏–∑–º|–≤—Ä—ñ–≤–Ω–æ–≤–∞–∂–µ–Ω—ñ—Å—Ç—å|–≥–∞—Ä–º–æ–Ω—ñ—è|—ñ–Ω–¥—É—ó–∑–º|–∫–≤—ñ—Ç–∫–∞|–∫—Ä–∞—Å–∞|–ª–∞–¥|–ª–æ—Ç–æ—Å|–º–∏—Ä|—Å–∏–º–≤–æ–ª —á–∏—Å—Ç–æ—Ç–∏|—Å–ø–æ–∫—ñ–π
ü™∏	–∫–æ—Ä–∞–ª	–∑–º—ñ–Ω–∞ –∫–ª—ñ–º–∞—Ç—É|–∫–æ—Ä–∞–ª|–º–æ—Ä–µ|–æ–∫–µ–∞–Ω|—Ä–∏—Ñ
ü™π	–ø–æ—Ä–æ–∂–Ω—î –≥–Ω—ñ–∑–¥–æ	–≥—ñ–ª–∫–∞|–≥–Ω—ñ–∑–¥–µ—á–∫–æ|–≥–Ω—ñ–∑–¥–æ|–≥–Ω—ñ–∑–¥—É–≤–∞–Ω–Ω—è|–¥—ñ–º|–ø–æ—Ä–æ–∂–Ω—î –≥–Ω—ñ–∑–¥–æ
ü™∫	–≥–Ω—ñ–∑–¥–æ –∑ –ø—Ç–∞—à–∏–Ω–∏–º–∏ —è–π—Ü—è–º–∏	–≥—ñ–ª–∫–∞|–≥–Ω—ñ–∑–¥–µ—á–∫–æ|–≥–Ω—ñ–∑–¥–æ|–≥–Ω—ñ–∑–¥–æ –∑ –ø—Ç–∞—à–∏–Ω–∏–º–∏ —è–π—Ü—è–º–∏|–≥–Ω—ñ–∑–¥–æ –∑ —è–π—Ü—è–º–∏|–≥–Ω—ñ–∑–¥—É–≤–∞–Ω–Ω—è|–ø—Ç–∞—Ö|—è–π—Ü–µ|—è–π—Ü—è
ü™ª	–≥—ñ–∞—Ü–∏–Ω—Ç	–≤–µ—Å–Ω–∞|–≥—ñ–∞—Ü–∏–Ω—Ç|–∫–≤—ñ—Ç–∫–∞|—Ä–æ—Å–ª–∏–Ω–∞|—Ñ—ñ–æ–ª–µ—Ç–æ–≤–∏–π
ü™º	–º–µ–¥—É–∑–∞	–±–µ–∑—Ö—Ä–µ–±–µ—Ç–Ω–∏–π|–∂–∞–ª–æ|–º–µ–¥—É–∑–∞|–º–æ—Ä–µ|–º–æ—Ä—Å—å–∫–∏–π|–æ–∫–µ–∞–Ω|–æ–ø—ñ–∫|—Ç–≤–∞—Ä–∏–Ω–∞|—â—É–ø–∞–ª—å—Ü—ñ
ü™Ω	–∫—Ä–∏–ª–æ	–∞–≤—ñ–∞—Ü—ñ—è|–∞–Ω–≥–µ–ª|–∞–Ω–≥–µ–ª—å—Å—å–∫–∏–π|–∫—Ä–∏–ª–æ|–ª–µ—Ç—ñ—Ç–∏|–º—ñ—Ñ|–º—ñ—Ñ–æ–ª–æ–≥—ñ—è|–Ω–µ–±–µ—Å–Ω–∏–π|–ø–æ–ª—ñ—Ç|–ø—Ç–∞—Ö
ü™æ	—Å—É—Ö–µ –¥–µ—Ä–µ–≤–æ	–±–µ–∑–ª–∏—Å—Ç–∏–π|–±–µ–∑–ø–ª—ñ–¥–Ω–∏–π|–≥—ñ–ª–∫–∏|–≥–æ–ª–∏–π|–¥–µ—Ä–µ–≤–æ|–∑–∏–º–∞|–º–µ—Ä—Ç–≤–∏–π|–ø–æ—Å—É—Ö–∞|—Å—Ç–æ–≤–±—É—Ä
ü™ø	–≥—É—Å–∞–∫	–±–µ—à–∫–µ—Ç|–≥–∞|–≥–∞–ª–∞—Å|–≥—É—Å–∞–∫|–≥—É—Å–∫–∞|–∑–≥—Ä–∞—è|–∫–ª–∏–Ω|–ø—Ç–∞—Ö|–ø—Ç–∏—Ü—è|—Ç–≤–∞—Ä–∏–Ω–∞
ü´Ä	—Å–µ—Ä—Ü–µ	–∞–Ω–∞—Ç–æ–º—ñ—á–Ω–∏–π|–≤–Ω—É—Ç—Ä—ñ—à–Ω—ñ–π –æ—Ä–≥–∞–Ω|–∫–∞—Ä–¥—ñ–æ–ª–æ–≥—ñ—è|–∫—Ä–æ–≤|–æ—Ä–≥–∞–Ω|–ø—É–ª—å—Å|—Å–µ—Ä—Ü–µ|—Å–µ—Ä—Ü–µ–±–∏—Ç—Ç—è|—Ü–µ–Ω—Ç—Ä|—á–µ—Ä–≤–æ–Ω–∏–π
ü´Å	–ª–µ–≥–µ–Ω—ñ	–≤–¥–∏—Ö|–≤–∏–¥–∏—Ö|–≤–Ω—É—Ç—Ä—ñ—à–Ω—ñ–π –æ—Ä–≥–∞–Ω|–¥–∏—Ö–∞–Ω–Ω—è|–ª–µ–≥–µ–Ω—ñ|–ª–µ–≥–µ–Ω—è|–æ—Ä–≥–∞–Ω|–ø–æ–¥–∏—Ö
ü´Ç	–ª—é–¥–∏ –æ–±—ñ–π–º–∞—é—Ç—å—Å—è	–≤–¥—è—á–Ω—ñ—Å—Ç—å|–≤—Ç—ñ—Ö–∞|–¥—Ä—É–∂–±–∞|–ª—é–±–æ–≤|–ª—é–¥–∏ –æ–±—ñ–π–º–∞—é—Ç—å—Å—è|–æ–±—ñ–π–º–∏|–ø—ñ–¥—Ç—Ä–∏–º–∫–∞|–ø—Ä–∏–≤—ñ—Ç–∞–Ω–Ω—è|–ø—Ä–æ—â–∞–Ω–Ω—è
ü´É	—á–æ–ª–æ–≤—ñ–∫ —ñ–∑ ¬´–≤–∞–≥—ñ—Ç–Ω–∏–º¬ª –∂–∏–≤–æ—Ç–æ–º	–≤–∞–≥—ñ—Ç–Ω–∞ –ª—é–¥–∏–Ω–∞|–≤–∞–≥—ñ—Ç–Ω—ñ—Å—Ç—å|–∂–∏–≤—ñ—Ç|–∑–¥—É—Ç—Ç—è –∂–∏–≤–æ—Ç–∞|–Ω–∞—ó–≤—Å—è|–ø–µ—Ä–µ—ó–¥–∞–Ω–Ω—è|—á–æ–ª–æ–≤—ñ–∫|—á–æ–ª–æ–≤—ñ–∫ —ñ–∑ ¬´–≤–∞–≥—ñ—Ç–Ω–∏–º¬ª –∂–∏–≤–æ—Ç–æ–º
ü´Ñ	–≤–∞–≥—ñ—Ç–Ω–∞ –ª—é–¥–∏–Ω–∞	–≤–∞–≥—ñ—Ç–Ω–∞ –∂—ñ–Ω–∫–∞|–≤–∞–≥—ñ—Ç–Ω–∞ –ª—é–¥–∏–Ω–∞|–≤–∞–≥—ñ—Ç–Ω—ñ—Å—Ç—å|–≤–µ–ª–∏–∫–∏–π –∂–∏–≤—ñ—Ç|–∑–¥—É—Ç—Ç—è –∂–∏–≤–æ—Ç–∞|–ø–µ—Ä–µ—ó–¥–∞–Ω–Ω—è|—Å–∏—Ç—ñ—Å—Ç—å
ü´Ö	–ª—é–¥–∏–Ω–∞ –∑ –∫–æ—Ä–æ–Ω–æ—é –Ω–∞ –≥–æ–ª–æ–≤—ñ	–∞—Ä–∏—Å—Ç–æ–∫—Ä–∞—Ç—ñ—è|–∫–æ—Ä–æ–ª–µ–≤–∞|–∫–æ—Ä–æ–ª—ñ–≤—Å—å–∫–∞ –æ—Å–æ–±–∞|–∫–æ—Ä–æ–ª—ñ–≤—Å—å–∫–∏–π|–∫–æ—Ä–æ–ª—å|–∫–æ—Ä–æ–Ω–∞|–ª—é–¥–∏–Ω–∞ –∑ –∫–æ—Ä–æ–Ω–æ—é –Ω–∞ –≥–æ–ª–æ–≤—ñ|–º–æ–Ω–∞—Ä—Ö|—Ü–∞—Ä|—Ü–∞—Ä–∏—Ü—è|—Ü–∞—Ä—Å—å–∫–∏–π
ü´Ü	–≤—ñ–¥–±–∏—Ç–æ–∫ –ø–∞–ª—å—Ü—è	–±–µ–∑–ø–µ–∫–∞|–¥–µ—Ç–µ–∫—Ç–∏–≤|–¥—Ä—É–∫|–∑–ª–æ—á–∏–Ω|—ñ–¥–µ–Ω—Ç–∏—Ñ—ñ–∫–∞—Ü—ñ—è|–∫—Ä–∏–º—ñ–Ω–∞–ª—ñ—Å—Ç–∏–∫–∞|–ø—ñ–¥–∫–∞–∑–∫–∞|—Å–ª—ñ–¥|—Ç–∞—î–º–Ω–∏—Ü—è
ü´é	–ª–æ—Å—å	–ª–æ—Å–∏—Ö–∞|–ª–æ—Å—å|—Ä–æ–≥–∏|—Å—Å–∞–≤–µ—Ü—å|—Ç–≤–∞—Ä–∏–Ω–∞
ü´è	–≤—ñ—Å–ª—é–∫	–≤—ñ—Å–ª—é–∫|—ñ—à–∞–∫|–º—É–ª|–æ—Å–µ–ª|–æ—Å–ª–∏—Ü—è|—Å—Å–∞–≤–µ—Ü—å|—Ç–≤–∞—Ä–∏–Ω–∞|—É–ø–µ—Ä—Ç–∏–π|—É–ø–µ—Ä—Ç—é—Ö
ü´ê	–ª–æ—Ö–∏–Ω–∞	—ó–∂–∞|–ª—ñ—Å–æ–≤—ñ —è–≥–æ–¥–∏|–ª–æ—Ö–∏–Ω–∞|—Å–∏–Ω—ñ —è–≥–æ–¥–∏|—Å–∏–Ω—è|—á–æ—Ä–Ω–∏—Ü—è|—è–≥–æ–¥–∞
ü´ë	—Å–æ–ª–æ–¥–∫–∏–π –ø–µ—Ä–µ—Ü—å	–±–æ–ª–≥–∞—Ä—Å—å–∫–∏–π –ø–µ—Ä–µ—Ü—å|–≤–µ–≥–µ—Ç–∞—Ä—ñ–∞–Ω—Å—å–∫–∞ —ó–∂–∞|–∑–µ–ª–µ–Ω–∏–π –ø–µ—Ä–µ—Ü—å|—ó–∂–∞|–æ–≤–æ—á|–ø–∞–ø—Ä–∏–∫–∞|–ø–µ—Ä–µ—Ü—å|—Å–æ–ª–æ–¥–∫–∏–π –ø–µ—Ä–µ—Ü—å
ü´í	–æ–ª–∏–≤–∫–∞	–≥—ñ–ª–∫–∞|—ó–∂–∞|–æ–ª–∏–≤–∫–∞|–æ–ª–∏–≤–∫–æ–≤–∞ –≥—ñ–ª–∫–∞|—è–≥–æ–¥–∞|—è–≥–æ–¥–∏
ü´ì	–∫–æ—Ä–∂	–∞—Ä–µ–ø–∞|—ó–∂–∞|–∫–∞–ª–∞—á|–∫–æ—Ä–∂|–ª–∞–≤–∞—à|–Ω–∞–∞–Ω|–ø–∞–ª—è–Ω–∏—Ü—è|–ø—ñ—Ç–∞|—Ç–æ—Ä—Ç–∏–ª—å—è|—Ö–ª—ñ–±
ü´î	—Ç–∞–º–∞–ª–µ	–∑–∞–≤–∏–≤–∞–Ω–µ—Ü—å|—ó–∂–∞|–º–µ–∫—Å–∏–∫–∞|–º–µ–∫—Å–∏–∫–∞–Ω—Å—å–∫–∞ —Å—Ç—Ä–∞–≤–∞|–ø–∞–º–æ–Ω—å—è|—Ä–æ–ª|—Ç–∞–º–∞–ª–µ|—Ç—ñ—Å—Ç–æ
ü´ï	—Ñ–æ–Ω–¥—é	–∞–ª—å–ø–∏|–≥–æ—Ä—â–∏—á–æ–∫|–∫–∞–∫–µ–ª–æ–Ω|–∫–∞—Å—Ç—Ä—é–ª—å–∫–∞|–ª–∏–∂—ñ|—Å–∏—Ä|—Ç–æ–ø–ª–µ–Ω–∏–π|—Ñ–æ–Ω–¥—é|—à–≤–µ–π—Ü–∞—Ä—Å—å–∫–∞ —Å—Ç—Ä–∞–≤–∞|—à–æ–∫–æ–ª–∞–¥
ü´ñ	—á–∞–π–Ω–∏–∫	–∑–∞–≤–∞—Ä–Ω–∏–∫|–∑–∞–≤–∞—Ä—é–≤–∞—Ç–∏|—ó–∂–∞|–Ω–∞–ø—ñ–π|–ø–æ—Å—É–¥|—á–∞–π|—á–∞–π–Ω–∏–∫
ü´ó	—Å–∫–ª—è–Ω–∫–∞, –∑ —è–∫–æ—ó –≤–∏–ª–∏–≤–∞—î—Ç—å—Å—è —Ä—ñ–¥–∏–Ω–∞	–≤–∏–ª–∏–≤–∞—Ç–∏|–≤–∏–ø–∞–¥–∫–æ–≤—ñ—Å—Ç—å|–≤–æ–¥–∞|–Ω–∞–ø—ñ–π|–ø–æ—Ä–æ–∂–Ω—è|–ø—Ä–æ–ª–∏–≤–∞—Ç–∏|—Ä–æ–∑–ª–∏—Ç–∏|—Å–∫–ª—è–Ω–∫–∞|—É–ø—Å
ü´ò	–∫–≤–∞—Å–æ–ª—è	–±–æ–±–∏|–±–æ–±–æ–≤—ñ|—ó–∂–∞|–∫–≤–∞—Å–æ–ª–∏–Ω–∞|–∫–≤–∞—Å–æ–ª—è|–Ω–µ–≤–µ–ª–∏–∫—ñ
ü´ô	–±–∞–Ω–∫–∞	–±–∞–Ω–∫–∞|—î–º–Ω—ñ—Å—Ç—å|–∑–±–µ—Ä—ñ–≥–∞–Ω–Ω—è|–Ω—ñ—á–æ–≥–æ|–ø–æ—Ä–æ–∂–Ω—è|—Å–ª–æ—ó–∫|—Å–æ—É—Å|—Å–ø–µ—Ü—ñ—ó
ü´ö	—ñ–º–±–∏—Ä	–∑–¥–æ—Ä–æ–≤ º—è|—ñ–º–±–∏—Ä|—ñ–º–±–∏—Ä–Ω–∏–π|–∫–æ—Ä—ñ–Ω–Ω—è|–Ω–∞—Ç—É—Ä–∞–ª—å–Ω–∏–π|–ø–∏–≤–æ|—Å–ø–µ—Ü—ñ—ó
ü´õ	—Å—Ç—Ä—É—á–æ–∫ –≥–æ—Ä–æ—Ö—É	–±—ñ–±|–±–æ–±–æ–≤—ñ|–≥–æ—Ä–æ—Ö|–≥–æ—Ä–æ—à–æ–∫|–µ–¥–∞–º–∞–º–µ|–∑–µ–ª–µ–Ω–∏–π|–æ–≤–æ—á|—Å—Ç—Ä—É—á–∫–æ–≤—ñ|—Å—Ç—Ä—É—á–æ–∫ –≥–æ—Ä–æ—Ö—É
ü´ú	–∫–æ—Ä–µ–Ω–µ–ø–ª—ñ–¥	–±—É—Ä—è–∫|–≤–µ–≥–∞–Ω—Å—Ç–≤–æ|–≤–µ–≥–µ—Ç–∞—Ä—ñ–∞–Ω—Å—Ç–≤–æ|—ó–∂–∞|–∫–æ—Ä—ñ–Ω—å|—Ä–µ–¥—å–∫–∞|—Ä—ñ–ø–∞|—Ä–æ—Å–ª–∏–Ω–∞|—Å–∞–¥|—Å–∞–ª–∞—Ç
ü´ü	–ª—è–ø–∫–∞	–±–µ–∑–ª–∞–¥|–±—Ä–∏–∑–∫–∏|–∫—Ä–∞–ø–ª—ñ|–ø–ª—è–º–∞|—Ä—ñ–¥–∏–Ω–∞|—Ä–æ–∑–ª–∏–≤–∞—Ç–∏|—Ñ–∞—Ä–±–∏|—Ö–æ–ª—ñ|—á–æ—Ä–Ω–∏–ª–æ
ü´†	—Ä–æ–∑–ø–ª–∞–≤–ª–µ–Ω–µ –æ–±–ª–∏—á—á—è	–∑–Ω–∏–∫–∞—Ç–∏|–ª–æ–ª|–Ω—ñ—è–∫–æ–≤–æ|–æ–±–ª–∏—á—á—è|–ø–ª–∞–≤–∏—Ç–∏—Å—è|—Ä–æ–∑—á–∏–Ω—è—Ç–∏—Å—è|—Å–∞—Ä–∫–∞–∑–º|—Å–ø–µ–∫–∞|—Ç–∞–Ω—É—Ç–∏|—Ç–µ–∫—Ç–∏|—Ö–∞—Ö–∞
ü´°	–æ–±–ª–∏—á—á—è, —â–æ –∫–æ–∑–∏—Ä—è—î	–±—É–¥–µ –∑—Ä–æ–±–ª–µ–Ω–æ|–∑–≥–æ–¥–∞|–∫–æ–∑–∏—Ä—è—Ç–∏|–æ–±–ª–∏—á—á—è|–û–ö|–ø–æ–≤–∞–≥–∞|—Ä–µ—Å–ø–µ–∫—Ç|—Å–∞–ª—é—Ç|—Å–ª—É—Ö–∞—é—Å—å|—Ç–∞–∫|—Ç–∞–∫ —Ç–æ—á–Ω–æ|—É–¥–∞—á—ñ|—á–µ—Å—Ç—å|—à–∞–Ω—É–≤–∞–Ω–Ω—è
ü´¢	–æ–±–ª–∏—á—á—è –∑ —Ä–æ–∑–ø–ª—é—â–µ–Ω–∏–º–∏ –æ—á–∏–º–∞ —ñ —Ä—É–∫–æ—é –Ω–∞ —Ä–æ—Ç—ñ	–¥–∏–≤–æ|–∑–¥–∏–≤—É–≤–∞–Ω–Ω—è|–º–æ–≤—á–∞–Ω–∫–∞|–º–æ–≤—á–∞—Ç–∏|–Ω–µ –≤—ñ—Ä—é|–Ω–µ –º–æ–∂–µ –±—É—Ç–∏|–Ω—ñ–≤—Ä–æ–∫—É|–æ –±–æ–∂–µ|–æ–±–ª–∏—á—á—è|–æ–≥–æ|–ø–µ—Ä–µ–ª—è–∫|—Å—é—Ä–ø—Ä–∏–∑|—Ç–∏—à–∞|—à–æ–∫
ü´£	–æ–±–ª–∏—á—á—è, —â–æ –ø—ñ–¥–≥–ª—è–¥–∞—î –æ–¥–Ω–∏–º –æ–∫–æ–º	–≤–∏–≥–ª—è–¥–∞—Ç–∏|–≤–∏—Ç—Ä—ñ—â–∞—î—Ç—å—Å—è|–∫–æ–Ω—Ñ—É–∑|–Ω–∞–ª—è–∫–∞–Ω–∏–π|–Ω—ñ—è–∫–æ–≤–æ|–æ–±–ª–∏—á—á—è|–æ–¥–Ω–µ –æ–∫–æ|–ø—ñ–¥–≥–ª—è–¥–∞—î|—Å–æ—Ä–æ–º º—è–∑–ª–∏–≤–∏–π|—Å–æ—Ä–æ–º–∏—Ç–∏—Å—è|—É–º–∏—Ä–∞—î –∑ —Ü—ñ–∫–∞–≤–æ—Å—Ç—ñ|—Ö–æ–≤–∞—Ç–∏—Å—è
ü´§	–æ–±–ª–∏—á—á—è –∑ —Ä–æ—Ç–æ–º –Ω–∞–≤—Å–∫—ñ—Å	–±–∞–π–¥—É–∂–µ|–∑–∞–ø–ª—É—Ç–∞—Ç–∏—Å—è|–∑–±–µ–Ω—Ç–µ–∂–µ–Ω–∏–π|–Ω–µ–≤–ø–µ–≤–Ω–µ–Ω—ñ—Å—Ç—å|–æ–±–ª–∏—á—á—è|—Ä–æ–∑—á–∞—Ä–æ–≤–∞–Ω–∏–π|—Å–∫–µ–ø—Ç–∏—Ü–∏–∑–º|—Å—É–º–Ω—ñ–≤|—Ç–∞ –Ω—É|—Ç–∞–∫ —Å–æ–±—ñ
ü´•	–æ–±–ª–∏—á—á—è –ø—É–Ω–∫—Ç–∏—Ä–æ–º	–±–∞–π–¥—É–∂–µ|–≤—Å–µ –æ–¥–Ω–æ|–¥–µ–ø—Ä–µ—Å—ñ—è|–∑–Ω–∏–∫–Ω—É—Ç–∏|—ñ–Ω—Ç—Ä–æ–≤–µ—Ä—Ç|–Ω–µ–≤–∏–¥–∏–º–∫–∞|–æ–±–ª–∏—á—á—è|–ø—Ä–∏–≥–Ω—ñ—á–µ–Ω–∏–π|—Å—Ö–æ–≤–∞–Ω–∏–π|—Å—Ö–æ–≤–∞—Ç–∏—Å—è|—Ç–∞–∫ —Å–æ–±—ñ|—Ö–æ–≤–∞—Ç–∏—Å—è
ü´¶	–∑–∞–∫—É—à–µ–Ω–∞ –Ω–∏–∂–Ω—è –≥—É–±–∞	–Ω–µ—Ä–≤–∏|–Ω—ñ—è–∫–æ–≤—ñ—Å—Ç—å|–ø–æ–º–∞–¥–∞|–ø–æ—Ü—ñ–ª—É–Ω–æ–∫|—Å–µ–∫—Å—É–∞–ª—å–Ω–æ|—Å—Ç—Ä–∞—Ö|—Å—Ç—É—Ä–±–æ–≤–∞–Ω—ñ—Å—Ç—å|—Ç—Ä–∏–≤–æ–≥–∞|—É–∫—É—Å|—Ñ–ª—ñ—Ä—Ç|—Ö–≤–∏–ª—é–≤–∞—Ç–∏—Å—å
ü´ß	–±—É–ª—å–±–∞—à–∫–∏	–±—É–ª—å–±–∞—à–∫–∞|–±—É–ª—å–±–∞—à–∫–∏|–±—É–ª—å–±–∞—à–∫–∏ –≥–∞–∑—É|–º–∏–ª–æ|–ø–µ—Ä–ª–∏–Ω–∞|–ø—ñ–¥ –≤–æ–¥–æ—é|–ø—É—Å–∫–∞—Ç–∏ –±—É–ª—å–±–∞—à–∫–∏|—á–∏—Å—Ç–∏—Ç–∏
ü´®	—Ç—Ä–µ–º—Ç–ª–∏–≤–µ –æ–±–ª–∏—á—á—è	–ë–æ–∂–µ|–≤—ñ–±—Ä–∞—Ü—ñ—è|–∑–µ–º–ª–µ—Ç—Ä—É—Å|–Ω–µ—Å–ø–æ–¥—ñ–≤–∞–Ω–∫–∞|–æ–±–ª–∏—á—á—è|–æ—à–µ–ª–µ—à–µ–Ω–Ω—è|–ø–∞–Ω—ñ–∫–∞|—Å–º–∞–π–ª|—Å—é—Ä–ø—Ä–∏–∑|—Ç—Ä–µ–º—Ç—ñ–Ω–Ω—è|—à–æ–∫
ü´©	–Ω–µ–≤–∏—Å–ø–∞–Ω–µ –æ–±–ª–∏—á—á—è	–≤–∏—Å–Ω–∞–∂–µ–Ω–Ω—è|–∑–∞–º–æ—Ä–µ–Ω—ñ—Å—Ç—å|–º—ñ—à–∫–∏|–Ω—É–¥—å–≥–∞|–æ–±–ª–∏—á—á—è|–æ—á—ñ|–ø—ñ–∑–Ω–æ|—Å–æ–Ω–ª–∏–≤—ñ—Å—Ç—å|—É—Ç–æ–º–∞
ü´∞	–∫–ª–∞—Ü–∞–Ω–Ω—è –ø–∞–ª—å—Ü—è–º–∏	<3|–≤–∞—Ä—Ç—ñ—Å—Ç—å|–≥—Ä–æ—à—ñ|–¥–æ—Ä–æ–≥–æ|–∫–ª–∞—Ü–∞–Ω–Ω—è –ø–∞–ª—å—Ü—è–º–∏|–∫–æ—à—Ç—É—î|–ª—é–±–æ–≤|–ø–ª–∞—Ç–∏|—Ä—É–∫–∞|—Å–µ—Ä—Ü–µ
ü´±	–¥–æ–ª–æ–Ω—è –≤–ø—Ä–∞–≤–æ	–≤–ø—Ä–∞–≤–æ|–¥–æ–ª–æ–Ω—è|–ø–æ—Ç–∏—Å–∫–∞—Ç–∏|–ø—Ä–∞–≤–∞ —Ä—É–∫–∞|–ø—Ä–∞–≤–æ—Ä—É—á|–ø—Ä–æ—Å—Ç—è–≥–Ω—É—Ç–∏|—Ä—É–∫–∞|—Ä—É–∫–æ—Å—Ç–∏—Å–∫–∞–Ω–Ω—è|—Ç—Ä–∏–º–∞—Ç–∏
ü´≤	–¥–æ–ª–æ–Ω—è –≤–ª—ñ–≤–æ	–≤–ª—ñ–≤–æ|–¥–æ–ª–æ–Ω—è|–ª—ñ–≤–∞ —Ä—É–∫–∞|–ª—ñ–≤–æ—Ä—É—á|–ø–æ—Ç–∏—Å–∫–∞—Ç–∏|–ø—Ä–æ—Å—Ç—è–≥–Ω—É—Ç–∏|—Ä—É–∫–∞|—Ä—É–∫–æ—Å—Ç–∏—Å–∫–∞–Ω–Ω—è|—Ç—Ä–∏–º–∞—Ç–∏
ü´≥	—Ä—É–∫–∞ –¥–æ–ª–æ–Ω–µ—é –≤–Ω–∏–∑	–≤–∑—è—Ç–∏|–≤–∏–ø—É—Å—Ç–∏—Ç–∏|–≤–∏–ø—É—Å—Ç–∏—Ç–∏ –∑ —Ä—É–∫–∏|–≤—ñ–¥–ø—É—Å–∫–∞—é|–∑—Ä–æ–Ω–∏—Ç–∏|–∫–∏—à!|–ø—ñ–¥–Ω—è—Ç–∏|—Ä—É–∫–∞|—Ä—É–∫–∞ –¥–æ–ª–æ–Ω–µ—é –≤–Ω–∏–∑
ü´¥	—Ä—É–∫–∞ –¥–æ–ª–æ–Ω–µ—é –≤–≥–æ—Ä—É	–≤–ø—ñ–π–º–∞—Ç–∏|–ª–æ–≤–∏—Ç–∏|–ø—ñ–¥—ñ–π–¥–∏|–ø—ñ–¥–∫–ª–∏–∫–∞—Ç–∏|–ø—ñ–¥–Ω—ñ–º–∞—Ç–∏|–ø—ñ–¥—Ö–æ–¥–∏—Ç–∏|–ø—Ä–æ–ø–æ–∑–∏—Ü—ñ—è|—Ä–æ–∑–∫–∞–∂–∏|—Å–∫–∞–∂–∏|—Ç—Ä–∏–º–∞—Ç–∏
ü´µ	–≤–∫–∞–∑—ñ–≤–Ω–∏–π –ø–∞–ª–µ—Ü—å, —â–æ –≤–∫–∞–∑—É—î –Ω–∞ –≥–ª—è–¥–∞—á–∞	–≤–∏|–≤–∫–∞–∑—ñ–≤–Ω–∏–π –ø–∞–ª–µ—Ü—å|–≤–∫–∞–∑—ñ–≤–Ω–∏–π –ø–∞–ª–µ—Ü—å, —â–æ –≤–∫–∞–∑—É—î –Ω–∞ –≥–ª—è–¥–∞—á–∞|–ø–∞–ª–µ—Ü—å|–ø–æ–∫–∞–∑—É–≤–∞—Ç–∏|—Ä—É–∫–∞|—Ç–∏|—Ç–∏–∫–∞—Ç–∏|—É–∫–∞–∑—É–≤–∞—Ç–∏|—â–æ –≤–∫–∞–∑—É—î –Ω–∞ –≥–ª—è–¥–∞—á–∞
ü´∂	–∂–µ—Å—Ç ¬´—Å–µ—Ä—Ü–µ¬ª	<3|–∂–µ—Å—Ç ¬´—Å–µ—Ä—Ü–µ¬ª|–∫–æ—Ö–∞–Ω–Ω—è|–ª—é–±–ª—é —Ç–µ–±–µ|–ª—é–±–æ–≤|—Ä—É–∫–∏|—Å–µ—Ä—Ü–µ
ü´∑	–¥–æ–ª–æ–Ω—è —à—Ç–æ–≤—Ö–∞—î –≤–ª—ñ–≤–æ	–≤—ñ–¥–º–æ–≤–∏—Ç–∏|–¥–∞–π|–∑–∞–±–ª–æ–∫—É–≤–∞—Ç–∏|–∑—É–ø–∏–Ω–∏—Ç–∏|–ª—ñ–≤–æ—Ä—É—á|–ª—è—Å–Ω—É—Ç–∏|–ø º—è—Ç—å|–ø—Ä–∏–ø–∏–Ω–∏|—Å—Ç–æ–ø|—à—Ç–æ–≤—Ö–∞—Ç–∏
ü´∏	–¥–æ–ª–æ–Ω—è —à—Ç–æ–≤—Ö–∞—î –≤–ø—Ä–∞–≤–æ	–≤—ñ–¥–º–æ–≤–∏—Ç–∏|–¥–∞–π|–∑–∞–±–ª–æ–∫—É–≤–∞—Ç–∏|–∑—É–ø–∏–Ω–∏—Ç–∏|–ª—è—Å–Ω—É—Ç–∏|–ø º—è—Ç—å|–ø—Ä–∞–≤–æ—Ä—É—á|–ø—Ä–∏–ø–∏–Ω–∏|—Å—Ç–æ–ø|—à—Ç–æ–≤—Ö–∞—Ç–∏
